::
medwell::medwell
all::all
valve::valve
chain::chain
switched::switched
sms::sms
lack::lack
actuators::actuators
alerting::alerting
existing::existing
coach::coach
bulb::bulb
follow::follow
decisions::decisions
compact::compact
content::content
decoy::decoy
maniac::maniac
to::to
cloudbased::cloudbased
does::does
helps::helps
kv_shriram::kv_shriram
stable::stable
analogous::analogous
include::include
dramatically::dramatically
resources::resources
uploaded::uploaded
@::@
updated::updated
very::very
end::end
railways::railways
emergencies::emergencies
faq::faq
every::every
2502-4752::2502-4752
ticket::ticket
betterment::betterment
vast::vast
entire::entire
school::school
-in::-in
skills::skills
evaluation::evaluation
button::button
1549-3636::1549-3636
solution::solution
try::try
p::p
budaraju::budaraju
small::small
lever::lever
prevent::prevent
facilitating::facilitating
raspberrypi.org::raspberrypi.org
coordinate::coordinate
core::core
sandip::sandip
built-in::built-in
balachandran::balachandran
across::across
slowed::slowed
honourable::honourable
growing::growing
further::further
estimated::estimated
leakage::leakage
even::even
cargo::cargo
adds::adds
complexities::complexities
saved::saved
brief::brief
networks::networks
access::access
public::public
indian::indian
railmaniac::railmaniac
above::above
retrieved::retrieved
shared::shared
;::;
method::method
publications::publications
efficient/enhanced::efficient/enhanced
full::full
transportation::transportation
pranksters::pranksters
indicator::indicator
reported::reported
busy::busy
jati::jati
sini::sini
active::active
prasetyo::prasetyo
along::along
change::change
n.p::n.p
passengers::passengers
great::great
copyright::copyright
14::14
institute::institute
slow::slow
k::k
completely::completely
experience::experience
leaving::leaving
amount::amount
published::published
usually::usually
proof::proof
studies::studies
looted::looted
purview::purview
digitally::digitally
secure::secure
campaign::campaign
cb.amrita.edu::cb.amrita.edu
taxpayers::taxpayers
establish::establish
cloud::cloud
buttons::buttons
use::use
mb::mb
from::from
usb::usb
would::would
give::give
two::two
punishments::punishments
scenarios::scenarios
few::few
depicted::depicted
camera::camera
call::call
telegraph::telegraph
automate::automate
6::6
taken::taken
scope::scope
themselves::themselves
until::until
more::more
initiated::initiated
schematic::schematic
share::share
company::company
under::under
validity::validity
phone::phone
train::train
real-time::real-time
continual::continual
central::central
cases::cases
insights::insights
sample::sample
1816-949x::1816-949x
word::word
rights::rights
this::this
science::science
challenge::challenge
work::work
remain::remain
10.11591/ijeecs.v6.i3.pp688-694::10.11591/ijeecs.v6.i3.pp688-694
renders::renders
can::can
already::already
making::making
monitoring::monitoring
root::root
something::something
control::control
computers::computers
reserved::reserved
figure::figure
escapes::escapes
process::process
allowed::allowed
india::india
loco::loco
high::high
locks::locks
his::his
pulling::pulling
numbers::numbers
want::want
arise::arise
velusamy::velusamy
times::times
information::information
needs::needs
requirements::requirements
turn::turn
provide::provide
secured::secured
comfort::comfort
algorithms::algorithms
1::1
how::how
vital::vital
indiatoday.intoday.in::indiatoday.intoday.in
earnings::earnings
ensure::ensure
mobile-based::mobile-based
product::product
mar::mar
undergoing::undergoing
huge::huge
may::may
after::after
diagram::diagram
hence::hence
tries::tries
records::records
such::such
law::law
data::data
efficiently::efficiently
a::a
rupees::rupees
diminishes::diminishes
attempt::attempt
third::third
issn::issn
robot::robot
automation::automation
coal::coal
272-284::272-284
so::so
688::688
suggest::suggest
vidyapeetham::vidyapeetham
pulled::pulled
retrieval::retrieval
triggering::triggering
operations::operations
tagged::tagged
serving::serving
help::help
areas::areas
move::move
years::years
whilst::whilst
paper::paper
through::through
*corresponding::*corresponding
innovative::innovative
mentioned::mentioned
still::still
journals::journals
its::its
tte::tte
before::before
delay::delay
rapidly::rapidly
monitor::monitor
22::22
crew::crew
better::better
systems::systems
iaes::iaes
prakash::prakash
wall-e::wall-e
covered::covered
2017::2017
main::main
image::image
overcome::overcome
then::then
them::them
someone::someone
halt::halt
thereby::thereby
kaushik::kaushik
number::number
9::9
jcs::jcs
they::they
misuse::misuse
stabilise::stabilise
now::now
provision::provision
day::day
possess::possess
easily::easily
january::january
university::university
drop::drop
appropriate::appropriate
novamizanti::novamizanti
did::did
stopped::stopped
each::each
found::found
entirely::entirely
out::out
|::|
prevailing::prevailing
improvise::improvise
manthan::manthan
everyone::everyone
citizens::citizens
best::best
revised::revised
related::related
comprising::comprising
challenges::challenges
comprises::comprises
mendonsa::mendonsa
court::court
entering::entering
authenticity::authenticity
venkitaramanan::venkitaramanan
our::our
really::really
shown::shown
mygov::mygov
network::network
'::'
rs::rs
since::since
crucial::crucial
viability::viability
research::research
increase::increase
replacing::replacing
swr::swr
7::7
internet::internet
print::print
cause::cause
viable::viable
datta::datta
workflow::workflow
hefty::hefty
free::free
reason::reason
carried::carried
york::york
put::put
sensors::sensors
wi-fi::wi-fi
upon::upon
care::care
halted::halted
connectivity::connectivity
steal::steal
could::could
transition::transition
feasible::feasible
initiate::initiate
place::place
circuit::circuit
routes::routes
uses::uses
pilots::pilots
loud::loud
jeas::jeas
speeds::speeds
first::first
major::major
initial::initial
saving::saving
probability::probability
scene::scene
one::one
will::will
devices::devices
general::general
done::done
notify::notify
another::another
carry::carry
impossible::impossible
message::message
miss::miss
prank::prank
given::given
reference::reference
service::service
utilization::utilization
introduction::introduction
together::together
durable::durable
system::system
construct::construct
2::2
passed::passed
compartment::compartment
him::him
way::way
mostly::mostly
that::that
explanation::explanation
eliminates::eliminates
immediate::immediate
released::released
short::short
incur::incur
a.balachandran::a.balachandran
than::than
11::11
10::10
13::13
scheme::scheme
15::15
effective::effective
16::16
en.wikipedia.org::en.wikipedia.org
second::second
express::express
legacy::legacy
risks::risks
derailing::derailing
accessed::accessed
and::and
documentation::documentation
1.1::1.1
raj::raj
locations::locations
mehta::mehta
talking::talking
say::say
chandak::chandak
manner::manner
have::have
need::need
facing::facing
confirms::confirms
any::any
vulnerable::vulnerable
mandatory::mandatory
functioning::functioning
built::built
patterns::patterns
efficient::efficient
vulnerabilities::vulnerabilities
mechanism::mechanism
contact::contact
also::also
potential::potential
take::take
which::which
689::689
worsening::worsening
channel::channel
sn::sn
memory::memory
towards::towards
multiple::multiple
shall::shall
who::who
paid::paid
extending::extending
connected::connected
plan::plan
representation::representation
device::device
plays::plays
vishwa::vishwa
picture::picture
doi::doi
especially::especially
loopholes::loopholes
mobile::mobile
alarm::alarm
123-9::123-9
request::request
brought::brought
pipe::pipe
giving::giving
proceedings::proceedings
definitely::definitely
kv::kv
mechanical::mechanical
crore::crore
applied::applied
surplus::surplus
show::show
detection::detection
anyway::anyway
halting::halting
bring::bring
gauge::gauge
solutions::solutions
keywords::keywords
kamath::kamath
find::find
staff::staff
692::692
693::693
690::690
691::691
based::based
ijeecs::ijeecs
694::694
implementation::implementation
situations::situations
delays::delays
state::state
should::should
penalty::penalty
only::only
implemented::implemented
pretty::pretty
money::money
override::override
8::8
improve::improve
b::b
achieve::achieve
mrigank::mrigank
coimbatore::coimbatore
slows::slows
handle::handle
goes::goes
get::get
between::between
stop::stop
cheaper::cheaper
next::next
courage::courage
infallible::infallible
theft::theft
new::new
during::during
onboard::onboard
installed::installed
aravind::aravind
unrestricted::unrestricted
distraction::distraction
prime::prime
hoses::hoses
on-board::on-board
embedded::embedded
approach::approach
generally::generally
copassengers::copassengers
remove::remove
calling::calling
architecture::architecture
release::release
+5.1v::+5.1v
fixed::fixed
where::where
valid::valid
view::view
available::available
inventive::inventive
art::art
peripherals::peripherals
superseding::superseding
locale::locale
notice::notice
module::module
observed::observed
analytics::analytics
computer::computer
are::are
2.2::2.2
2.1::2.1
optimum::optimum
labour::labour
locals::locals
situation::situation
surveyor::surveyor
draws::draws
pictures::pictures
missing::missing
definite::definite
below::below
portrayed::portrayed
besra::besra
3::3
identification::identification
routine::routine
probably::probably
numerous::numerous
checks::checks
sciences::sciences
we::we
do::do
25::25
jharkhand::jharkhand
attention::attention
job::job
co-passengers::co-passengers
wastage::wastage
20::20
come::come
21::21
faced::faced
received::received
last::last
always::always
irfca::irfca
many::many
annual::annual
regions::regions
april::april
connection::connection
buzz::buzz
railway::railway
whole::whole
rama::rama
comes::comes
vent::vent
compromising::compromising
consume::consume
point::point
reasons::reasons
sweet::sweet
robotics::robotics
improper::improper
alone::alone
tons::tons
adding::adding
cr::cr
centralised::centralised
vasudevan::vasudevan
100::100
considering::considering
pp::pp
10.3844/jcssp.2014.272.284::10.3844/jcssp.2014.272.284
publishing::publishing
powered::powered
due::due
been::been
strategy::strategy
much::much
interest::interest
expected::expected
priyadarsini::priyadarsini
proposal::proposal
prototype::prototype
board::board
engine::engine
life::life
rather::rather
controlled::controlled
both::both
400::400
2015::2015
ensuring::ensuring
minister::minister
input::input
abhishek::abhishek
despite::despite
an::an
driver::driver
travelling::travelling
those::those
pilot::pilot
case::case
handling::handling
developing::developing
these::these
reliable::reliable
smartness::smartness
engineering::engineering
air::air
aim::aim
technical::technical
while::while
ar::ar
abrupt::abrupt
2013::2013
country::country
stopping::stopping
misutilization::misutilization
inexpensive::inexpensive
interconnected::interconnected
procedure::procedure
~::~
supply::supply
examiner::examiner
manually::manually
vol::vol
is::is
drawbacks::drawbacks
thus::thus
it::it
jungles::jungles
ii::ii
middle::middle
unit::unit
sudden::sudden
brake::brake
reports::reports
in::in
periasamy::periasamy
if::if
capture::capture
cloud-based::cloud-based
authenticated::authenticated
ample::ample
ijra::ijra
author::author
perform::perform
things::things
make::make
same::same
adverse::adverse
when::when
parts::parts
kevin::kevin
ganapathy::ganapathy
avoids::avoids
android::android
gets::gets
unharmed::unharmed
used::used
iot::iot
rail::rail
youngsters::youngsters
hand::hand
coaches::coaches
moving::moving
purpose::purpose
internal::internal
validate::validate
single::single
database::database
possessed::possessed
4.2::4.2
well::well
anybody::anybody
analysis::analysis
compartments::compartments
thought::thought
person::person
without::without
trains::trains
alarms::alarms
position::position
the::the
breaker::breaker
putra::putra
meet::meet
stations::stations
protocol::protocol
proposed::proposed
among::among
being::being
captures::captures
304-313::304-313
proposes::proposes
stored::stored
identify::identify
human::human
immediately::immediately
n::n
miss-utilization::miss-utilization
speed::speed
yet::yet
captured::captured
web::web
rapid::rapid
thankfully::thankfully
arumugam::arumugam
alternate::alternate
capabilities::capabilities
simple::simple
lets::lets
causing::causing
4::4
easy::easy
5::5
has::has
build::build
indonesian::indonesian
australia::australia
increased::increased
emergency::emergency
government::government
innovate.mygov.in::innovate.mygov.in
possible::possible
irfca.org::irfca.org
burden::burden
press::press
using::using
part::part
accepted::accepted
advanced::advanced
vasudevan*::vasudevan*
loss::loss
amrita::amrita
like::like
obvious::obvious
reduces::reduces
manual::manual
unnecessary::unnecessary
serves::serves
specific::specific
unstable::unstable
robbery::robbery
follows::follows
become::become
security::security
robbers::robbers
signal::signal
3000::3000
pertaining::pertaining
right::right
old::old
methods::methods
deal::deal
people::people
deepthi::deepthi
some::some
back::back
authority::authority
l::l
trends::trends
economic::economic
hassle::hassle
gpio::gpio
proofs::proofs
provided::provided
for::for
micro::micro
highest::highest
though::though
stops::stops
e-mail::e-mail
critical::critical
market::market
provides::provides
innovation::innovation
three::three
chains::chains
?::?
be::be
particular::particular
object::object
run::run
scientific::scientific
power::power
june::june
journal::journal
processing::processing
communicate::communicate
ensures::ensures
pressure::pressure
lamps::lamps
nowhere::nowhere
chain-pulling::chain-pulling
raspberry::raspberry
plk::plk
by::by
on::on
about::about
goods::goods
rare::rare
working::working
most::most
of::of
sri::sri
reduced::reduced
supervised::supervised
efforts::efforts
introduced::introduced
or::or
computational::computational
facility::facility
communication::communication
into::into
usa::usa
servers::servers
down::down
services::services
guard::guard
references::references
raises::raises
primarily::primarily
schematics::schematics
reducing::reducing
intervention::intervention
brakes::brakes
there::there
long::long
start::start
low::low
lot::lot
medium::medium
north::north
shriram::shriram
triggered::triggered
enough::enough
loco-pilot::loco-pilot
anywhere::anywhere
but::but
wireless::wireless
collected::collected
technologies::technologies
trying::trying
with::with
he::he
reset::reset
pull::pull
made::made
evident::evident
whether::whether
indiasamvad.co.in::indiasamvad.co.in
official::official
smooth::smooth
up::up
us::us
international::international
2.5a::2.5a
complications::complications
problem::problem
similar::similar
passenger::passenger
units::units
associated::associated
600::600
computing::computing
curvatures::curvatures
abstract::abstract
year::year
advancements::advancements
fellow::fellow
meanwhile::meanwhile
as::as
warning::warning
pre-programmed::pre-programmed
at::at
tribune::tribune
pis::pis
check::check
adelaide::adelaide
.10.3923/jeasci.2013.304.313::.10.3923/jeasci.2013.304.313
4.1::4.1
4.3::4.3
no::no
not::not
faces::faces
storage::storage
tiwari::tiwari
application::application
other::other
electrical::electrical
details::details
digital::digital
department::department
12::12
pi::pi
intention::intention
conclusion::conclusion
convicts::convicts
's::'s
braking::braking
problems::problems
whistling::whistling
includes::includes
helping::helping
sure::sure
chance::chance
important::important
allowing::allowing
coverage::coverage
rural::rural
authorities::authorities
incurred::incurred
derail::derail
ttes::ttes
remote::remote
trail::trail
required::required
daily::daily
indirectly::indirectly
itself::itself
time::time
serious::serious
accidents::accidents
having::having
once::once
