::
limited::limited
similarity::similarity
consists::consists
relationships::relationships
aub::aub
edward::edward
under::under
updated::updated
connects::connects
every::every
vast::vast
school::school
`is::`is
unrelated::unrelated
keygraph::keygraph
indices::indices
competencies::competencies
force::force
fpfile::fpfile
direct::direct
approximation::approximation
chen::chen
estimated::estimated
even::even
understandability::understandability
selected::selected
above::above
designing::designing
new::new
increasing::increasing
kamada::kamada
here::here
represented::represented
path::path
100::100
balance::balance
items::items
study::study
completely::completely
explained::explained
brought::brought
would::would
motivate::motivate
substitutions::substitutions
m0::m0
strike::strike
type::type
until::until
adjacency::adjacency
90::90
intra24::intra24
must::must
1991::1991
word::word
1994::1994
1996::1996
work::work
temperatures::temperatures
install::install
concepts::concepts
root::root
example::example
indicated::indicated
give::give
implementations::implementations
involve::involve
indicates::indicates
w2pointers::w2pointers
want::want
times::times
end::end
provide::provide
how::how
adjacent::adjacent
lan::lan
description::description
after::after
mesh::mesh
lay::lay
types::types
effective::effective
helsinki::helsinki
complexity::complexity
algorithms::algorithms
decreasing::decreasing
ethernet::ethernet
order::order
interpretation::interpretation
over::over
vary::vary
dijkstra::dijkstra
6.4::6.4
6.3::6.3
6.2::6.2
6.1::6.1
scoring::scoring
fig.4.1.system::fig.4.1.system
better::better
fig::fig
-index::-index
easier::easier
then::then
them::them
combination::combination
repulsive::repulsive
they::they
heiko::heiko
riesco::riesco
represents::represents
l::l
each::each
side::side
co-occurrence::co-occurrence
used::used
combining::combining
substantially::substantially
aids::aids
extract::extract
network::network
rc::rc
foundation::foundation
turning::turning
standard::standard
formation::formation
estimate::estimate
created::created
xue::xue
+1::+1
incorporated::incorporated
fig.6.4::fig.6.4
fig.6.3::fig.6.3
fig.6.2::fig.6.2
fig.6.1::fig.6.1
purpose::purpose
already::already
features::features
primary::primary
another::another
bottom-up::bottom-up
similarly::similarly
top::top
master::master
inter-topic::inter-topic
tool::tool
serve::serve
distance::distance
keyword::keyword
tree::tree
project::project
idle::idle
classes::classes
extracting::extracting
bridge::bridge
mina::mina
manner::manner
tells::tells
implemented::implemented
indexes::indexes
subjects::subjects
forces::forces
blue::blue
transactions::transactions
metrics::metrics
simplify::simplify
germany::germany
entry::entry
phase::phase
observation::observation
m::m
vertices::vertices
sum::sum
came::came
20-30::20-30
heuristics::heuristics
colors::colors
radio::radio
keywords::keywords
layout::layout
proposed::proposed
implementation::implementation
explain::explain
version::version
integrate::integrate
do::do
10::10
db::db
television::television
foremost::foremost
15::15
contributes::contributes
textbooks::textbooks
architecture::architecture
automatic::automatic
traverse::traverse
observed::observed
w2::w2
w1::w1
fail::fail
best::best
techniques::techniques
said::said
wikipedia::wikipedia
protected::protected
conceptual::conceptual
drawn::drawn
tolerance::tolerance
discovery::discovery
we::we
wd::wd
terms::terms
advantages/disadvantages::advantages/disadvantages
nature::nature
weak::weak
however::however
`similar::`similar
motto::motto
improve::improve
faced::faced
extracts::extracts
against::against
data-structure::data-structure
contribution::contribution
col::col
generalization-specialization::generalization-specialization
november::november
conference::conference
engines::engines
basis::basis
union::union
three::three
been::been
extraction::extraction
much::much
basic::basic
website::website
deeper::deeper
sunshine::sunshine
comprehensiveness::comprehensiveness
agrawal::agrawal
chile::chile
con-considering::con-considering
employ::employ
aid::aid
property::property
k::k
cons::cons
data-structures::data-structures
is::is
it::it
in::in
ie::ie
pointer::pointer
if::if
containing::containing
perform::perform
make::make
linked::linked
potentially::potentially
connectedness::connectedness
hierarchies::hierarchies
several::several
min=abs::min=abs
potentials::potentials
5.3.1::5.3.1
5.1.1::5.1.1
5.1.2::5.1.2
the::the
paradigm::paradigm
left::left
protocol::protocol
just::just
proposes::proposes
identify::identify
human::human
yet::yet
previous::previous
visualization::visualization
enters::enters
candidate::candidate
had::had
belongs::belongs
easy::easy
has::has
gave::gave
possible::possible
clustered::clustered
depicts::depicts
occurring::occurring
appearing::appearing
manual::manual
specific::specific
rakesh::rakesh
sparse::sparse
right::right
people::people
statistic::statistic
for::for
bottom::bottom
/::/
contributing::contributing
kruskal::kruskal
properties::properties
chapter::chapter
o::o
slightly::slightly
automatically::automatically
statements::statements
nodes/terms::nodes/terms
often::often
rely::rely
support::support
initial::initial
way::way
resulted::resulted
was::was
head::head
medium::medium
form::form
some::some
removes::removes
wireless::wireless
heap::heap
removed::removed
inside::inside
maximum::maximum
estonia::estonia
abstract::abstract
''::''
inter-cluster::inter-cluster
proves::proves
constructed::constructed
no::no
when::when
interested::interested
role::role
node::node
's::'s
models::models
variable::variable
faster::faster
assume::assume
interval::interval
together::together
time::time
push::push
nxn::nxn
hill-climbing::hill-climbing
concept::concept
graph::graph
technique::technique
environment::environment
0::0
finally::finally
reingold::reingold
choice::choice
entries::entries
exact::exact
partitions::partitions
level::level
standards::standards
item::item
quick::quick
unexpected::unexpected
says::says
occurrence::occurrence
insignificant::insignificant
discover::discover
cost::cost
eades::eades
appear::appear
current::current
international::international
supporting::supporting
understanding::understanding
alone::alone
along::along
change::change
benson::benson
box::box
studied::studied
commonly::commonly
suggestion::suggestion
usually::usually
studies::studies
useful::useful
extra::extra
flexibility::flexibility
traversing::traversing
by::by
criteria::criteria
australian::australian
granularities::granularities
``::``
m=m+1::m=m+1
appendix::appendix
cases::cases
effort::effort
capturing::capturing
insights::insights
modified::modified
believes::believes
values::values
can::can
following::following
making::making
figure::figure
sample::sample
weighting::weighting
spanning::spanning
occur::occur
pre-defined::pre-defined
monitoring::monitoring
divided::divided
1::1
till::till
speaks::speaks
parameter::parameter
map::map
5.1::5.1
may::may
spot::spot
needs::needs
applications::applications
produce::produce
designed::designed
improving::improving
representations::representations
data::data
5.5::5.5
natural::natural
frick::frick
explicit::explicit
inhabitants::inhabitants
so::so
representation::representation
serving::serving
indeed::indeed
displayed::displayed
graphviz::graphviz
structuring::structuring
statistical::statistical
ieee::ieee
forms::forms
platform::platform
main::main
thereby::thereby
views::views
rotations::rotations
lesser::lesser
not::not
now::now
discuss::discuss
term::term
name::name
possibilities::possibilities
domain::domain
retrieve::retrieve
ex::ex
adequately::adequately
predefined::predefined
factors::factors
looking::looking
internet::internet
shows::shows
queries::queries
quite::quite
statistics::statistics
unwanted::unwanted
axioms::axioms
language::language
frequent::frequent
first::first
valuevariables::valuevariables
omitted::omitted
variables::variables
one::one
fast::fast
directly::directly
impossible::impossible
array::array
open::open
size::size
given::given
necessarily::necessarily
checked::checked
indicate::indicate
2::2
structures::structures
gives::gives
mining::mining
mostly::mostly
that::that
representing::representing
than::than
11::11
wide::wide
13::13
12::12
impractical::impractical
14::14
17::17
16::16
19::19
18::18
require::require
r::r
were::were
outcome::outcome
and::and
topics::topics
say::say
any::any
subtopic::subtopic
efficient::efficient
answering::answering
ideas::ideas
potential::potential
take::take
green::green
santiago::santiago
multiple::multiple
enter::enter
molecule::molecule
fails::fails
pair::pair
pages::pages
especially::especially
considered::considered
average::average
later::later
playing::playing
professional::professional
precise::precise
show::show
discovered::discovered
notions::notions
apriori::apriori
3::3
september::september
only::only
going::going
edgeweight::edgeweight
get::get
fig.5.2::fig.5.2
aim::aim
unimportant::unimportant
nels::nels
gem::gem
reveal::reveal
key-graph::key-graph
settings::settings
mapped::mapped
where::where
up::up
connections::connections
ii+1::ii+1
ways::ways
representatives::representatives
behind::behind
between::between
inorder::inorder
across::across
notice::notice
august::august
parent::parent
analyzes::analyzes
analyzed::analyzed
come::come
many::many
23::23
word-distance::word-distance
comes::comes
among::among
color::color
pop::pop
spans::spans
associated::associated
considering::considering
combines::combines
caas::caas
relatedness::relatedness
combined::combined
wants::wants
enable::enable
formed::formed
observe::observe
those::those
case::case
disconnected::disconnected
topic-subtopic::topic-subtopic
these::these
fakultat::fakultat
profiles::profiles
n't::n't
metric::metric
according::according
cluster::cluster
binary::binary
different::different
develop::develop
author::author
same::same
document::document
ludwig::ludwig
extended::extended
closest::closest
disadvantages::disadvantages
forcedirected::forcedirected
edges::edges
jj+1::jj+1
amounts::amounts
without::without
components::components
very::very
model::model
researchers::researchers
kawai::kawai
being::being
captures::captures
rest::rest
n::n
speed::speed
captured::captured
spring-embedded::spring-embedded
seems::seems
except::except
4::4
around::around
rules::rules
daro::daro
world::world
identifying::identifying
reduces::reduces
benefit::benefit
t::t
output::output
provided::provided
fluids::fluids
provides::provides
ontology/semantic::ontology/semantic
semantically::semantically
ornamentation::ornamentation
refer::refer
power::power
thistlewaite::thistlewaite
ontology::ontology
on::on
of::of
discussed::discussed
meaning::meaning
or::or
references::references
487-499::487-499
determine::determine
intervention::intervention
removing::removing
there::there
low::low
lot::lot
.e.g::.e.g
amongst::amongst
e::e
with::with
miguel::miguel
>::>
subclasses::subclasses
ab::ab
certain::certain
general::general
as::as
reliability::reliability
at::at
file::file
lvarez::lvarez
incorrect::incorrect
4.4::4.4
4.1::4.1
4.3::4.3
4.2::4.2
sizesize::sizesize
hybrid::hybrid
graduate::graduate
field::field
5::5
you::you
karlsruhe::karlsruhe
separate::separate
sub-clusters::sub-clusters
includes::includes
n0::n0
important::important
5.4.1::5.4.1
building::building
edge-weights::edge-weights
represent::represent
all::all
semantic::semantic
lack::lack
to::to
nodes::nodes
belonging::belonging
edge-weight::edge-weight
far::far
list::list
applicable::applicable
large::large
small::small
20th::20th
yukio::yukio
past::past
design::design
further::further
what::what
sub::sub
section::section
abs::abs
method::method
segmentation::segmentation
hash::hash
answers::answers
operating::operating
i.e::i.e
urbana-champaign::urbana-champaign
strong::strong
observing::observing
search::search
experience::experience
proportionality::proportionality
followed::followed
analyzing::analyzing
executable::executable
takes::takes
answered::answered
objectives::objectives
contains::contains
two::two
betweenness::betweenness
6::6
taken::taken
more::more
particular::particular
known::known
foundations::foundations
coincidently::coincidently
mehldau::mehldau
middle::middle
science::science
installing::installing
compare::compare
suggestions::suggestions
minimum::minimum
numbers::numbers
!::!
information::information
5.2::5.2
5.3::5.3
5.4::5.4
goal::goal
5.8::5.8
acts::acts
maps::maps
influences::influences
explains::explains
fp::fp
simplicity::simplicity
tried::tried
capture::capture
mapping::mapping
tries::tries
response::response
fn::fn
a::a
prerequisites::prerequisites
keyfile::keyfile
retrieval::retrieval
help::help
hierarchy::hierarchy
developed::developed
through::through
its::its
25::25
26::26
27::27
20::20
21::21
22::22
termed::termed
28::28
29::29
systems::systems
good::good
framework::framework
walls::walls
association::association
easily::easily
found::found
weight::weight
generation::generation
osaka::osaka
hard::hard
reduce::reduce
idea::idea
connect::connect
deals::deals
guess.sh::guess.sh
p::p
since::since
denotes::denotes
tallinn::tallinn
7::7
srikant::srikant
roofs::roofs
reason::reason
base::base
generate::generate
e.g::e.g
finland::finland
w::w
major::major
relate::relate
number::number
linking::linking
done::done
passes::passes
guess::guess
introduction::introduction
leading::leading
least::least
calculations::calculations
option::option
relationship::relationship
authors::authors
techniques/methods::techniques/methods
b::b
cyclic::cyclic
imply::imply
determined::determined
novak::novak
null::null
paths::paths
also::also
generalized::generalized
finding::finding
play::play
added::added
kai::kai
measures::measures
reach::reach
most::most
fruchterman6::fruchterman6
significant::significant
nothing::nothing
windows::windows
drawing::drawing
traditional::traditional
4.2.2::4.2.2
4.2.1::4.2.1
masahiko::masahiko
thomas::thomas
relation::relation
entity::entity
screenshots::screenshots
networks::networks
completion::completion
parameters::parameters
=w2::=w2
factor::factor
8::8
accurate::accurate
columns::columns
his::his
hit::hit
permission::permission
dependent::dependent
yachida::yachida
preparing::preparing
closely::closely
worst-case::worst-case
common::common
scanning::scanning
set::set
achieves::achieves
see::see
individual::individual
are::are
close::close
2.7::2.7
graphbased::graphbased
visualize::visualize
currently::currently
various::various
creating::creating
heuristic::heuristic
j+1::j+1
scalability::scalability
incident::incident
ranked::ranked
interface::interface
both::both
informatik::informatik
foreign::foreign
connection::connection
became::became
finds::finds
point::point
simple::simple
corresponds::corresponds
kawaii::kawaii
consuming::consuming
create::create
strategy::strategy
describes::describes
extends::extends
generating::generating
else::else
understand::understand
extracted::extracted
fur::fur
while::while
32::32
30::30
vol::vol
breadth-first::breadth-first
itself::itself
belong::belong
wherein::wherein
widely::widely
9::9
resulting::resulting
higher::higher
development::development
literature::literature
lie::lie
keys::keys
comprehensive::comprehensive
domains::domains
levels::levels
uses::uses
user::user
stack::stack
lower::lower
task::task
database::database
analysis::analysis
edge::edge
visualizations::visualizations
weakest::weakest
precedence::precedence
questions::questions
using::using
cut::cut
conclusions::conclusions
source::source
relevance::relevance
input::input
doors::doors
demands::demands
sorting::sorting
d::d
follows::follows
`0::`0
essential::essential
pertaining::pertaining
methods::methods
creation::creation
hlberg::hlberg
back::back
towards::towards
3.2::3.2
examples::examples
3.1::3.1
oscillations::oscillations
describing::describing
though::though
pros::pros
connecting::connecting
eliminate::eliminate
proc::proc
be::be
run::run
processing::processing
step::step
metaphor::metaphor
intense::intense
analysing::analysing
dormant::dormant
marin::marin
d-76128::d-76128
range::range
subtopics::subtopics
into::into
within::within
fnfile::fnfile
proportional::proportional
clustering::clustering
rows::rows
span::span
retrieving::retrieving
long::long
analyze::analyze
files::files
link::link
multilevel::multilevel
line::line
expressivity::expressivity
directed::directed
fig.5.1::fig.5.1
partitioning::partitioning
fig.5.3::fig.5.3
fig.5.4::fig.5.4
fig.5.5::fig.5.5
fig.5.6::fig.5.6
fig.5.7::fig.5.7
fig.5.8::fig.5.8
fig.5.9::fig.5.9
sifting::sifting
us::us
theoretical::theoretical
exploration::exploration
similar::similar
constant::constant
armstrong::armstrong
defined::defined
engineering::engineering
filefile::filefile
defines::defines
4.2.3::4.2.3
%::%
rains::rains
application::application
`uses::`uses
users::users
backbone::backbone
problems::problems
expressing::expressing
helping::helping
generated::generated
co-occurring::co-occurring
structure::structure
implies::implies
algorithm::algorithm
required::required
weights::weights
2008::2008
requires::requires
having::having
once::once
code::code
vldb::vldb
results::results
existing::existing
eds::eds
query::query
issues::issues
helps::helps
visualizing::visualizing
undirected::undirected
indicating::indicating
unzip::unzip
presently::presently
continued::continued
categories::categories
entire::entire
-if::-if
try::try
smaller::smaller
educators::educators
layouts::layouts
download::download
k-item::k-item
index::index
giving::giving
find::find
cell::cell
experiment::experiment
;::;
exercise::exercise
links/edges::links/edges
degree::degree
len::len
let::let
ubuntu::ubuntu
39::39
38::38
33::33
involved::involved
31::31
larger::larger
37::37
36::36
35::35
34::34
survey::survey
involves::involves
named::named
boolean::boolean
names::names
apply::apply
use::use
andreas::andreas
from::from
&::&
next::next
few::few
sort::sort
becomes::becomes
k+1::k+1
occurred::occurred
sizeno::sizeno
topic::topic
account::account
f::f
this::this
anywhere::anywhere
proof::proof
links::links
process::process
ontologically::ontologically
frequent.if::frequent.if
high::high
effectively::effectively
assumptions::assumptions
employs::employs
instead::instead
profile::profile
stop::stop
collection::collection
intercluster::intercluster
physical::physical
element::element
allow::allow
fruchterman-reingold::fruchterman-reingold
transitivity::transitivity
including::including
ohsawa::ohsawa
perfect::perfect
bridges::bridges
12.04::12.04
choose::choose
clusters::clusters
<::<
greater::greater
python::python
practice::practice
indexing::indexing
day::day
university::university
identified::identified
identifies::identifies
eases::eases
subset::subset
inputs::inputs
related::related
books::books
our::our
80::80
out::out
category::category
matrix::matrix
'::'
include::include
adaptive::adaptive
supports::supports
integrated::integrated
red::red
greedy::greedy
intra-topic::intra-topic
approaches::approaches
shortest::shortest
phrases::phrases
could::could
keep::keep
length::length
explored::explored
hence::hence
suffix::suffix
third::third
occurrences::occurrences
such::such
quality::quality
system::system
relations::relations
chapter-1::chapter-1
their::their
intermediate::intermediate
chapter-5::chapter-5
chapter-7::chapter-7
chapter-6::chapter-6
xiangfeng::xiangfeng
final::final
detection::detection
inversely::inversely
result::result
automates::automates
internet-protocols::internet-protocols
have::have
need::need
clearly::clearly
k*c::k*c
documents::documents
min::min
theoretic::theoretic
able::able
mechanism::mechanism
instance::instance
which::which
subject::subject
=::=
accuracy::accuracy
connected::connected
placement::placement
graphs::graphs
proceedings::proceedings
construction::construction
databases::databases
fact::fact
text::text
visualized::visualized
bring::bring
=n::=n
based::based
knowledge::knowledge
should::should
entities::entities
bases::bases
employed::employed
local::local
`data::`data
achieve::achieve
=0::=0
means::means
overall::overall
words::words
quantifies::quantifies
cooccurrence::cooccurrence
fruchterman::fruchterman
approach::approach
contain::contain
fixed::fixed
view::view
intervening::intervening
official::official
acquired::acquired
national::national
module::module
computer::computer
statistically::statistically
closer::closer
pattern::pattern
luo::luo
importance::importance
efficiency::efficiency
key::key
david::david
taking::taking
etc::etc
passing::passing
ca::ca
adding::adding
universitat::universitat
addition::addition
yan::yan
hawking::hawking
degrees::degrees
ontologies::ontologies
define::define
corresponding::corresponding
c::c
an::an
present::present
unlike::unlike
value::value
will::will
fondn::fondn
thus::thus
helped::helped
/n::/n
.this::.this
highlighted::highlighted
gets::gets
tedious::tedious
af-heap::af-heap
frequently::frequently
transaction::transaction
functionalities::functionalities
i::i
well::well
patterns::patterns
sets::sets
44::44
less::less
increasingly::increasingly
proximity::proximity
obtain::obtain
43::43
stored::stored
years::years
paul::paul
illinois::illinois
web::web
ramakrishnan::ramakrishnan
lattice::lattice
add::add
combine::combine
attractive::attractive
k-1::k-1
homework::homework
jython::jython
know::know
intersection::intersection
necessary::necessary
like::like
become::become
works::works
because::because
sequence::sequence
searching::searching
authority::authority
demonstrates::demonstrates
does::does
slight::slight
journal::journal
although::although
wlist::wlist
about::about
carried::carried
extension::extension
getting::getting
universe::universe
introduces::introduces
dependency::dependency
statement::statement
transitive::transitive
software::software
own::own
networking::networking
noticed::noticed
coocurrence::coocurrence
function::function
but::but
repeated::repeated
hierarchical::hierarchical
convergence::convergence
he::he
count::count
reiska::reiska
made::made
wise::wise
gravitational::gravitational
j::j
below::below
frequency::frequency
limit::limit
arne::arne
problem::problem
display::display
non-existent::non-existent
int::int
functions::functions
compared::compared
48::48
46::46
47::47
w-1::w-1
45::45
42::42
detail::detail
40::40
41::41
other::other
compares::compares
details::details
conclusion::conclusion
wordlist::wordlist
kinds::kinds
variation::variation
rule::rule
file-file::file-file
