::
limited::limited
dynamic::dynamic
consists::consists
calculate::calculate
fine-grained::fine-grained
characterised::characterised
rise::rise
every::every
affect::affect
solution::solution
vector::vector
succession::succession
licence-free::licence-free
post-processing::post-processing
second::second
estimated::estimated
even::even
established::established
errors::errors
specification::specification
selected::selected
above::above
new::new
increasing::increasing
here::here
localisation::localisation
reported::reported
asymmetry::asymmetry
active::active
path::path
100::100
logarithmic::logarithmic
latapy::latapy
fingerprint-based::fingerprint-based
items::items
study::study
permit::permit
changes::changes
highly::highly
total::total
unit::unit
experimentation::experimentation
would::would
achieve::achieve
asses::asses
overhead::overhead
therefore::therefore
25th::25th
separated::separated
conclusions::conclusions
award::award
ward::ward
95::95
must::must
bulkier::bulkier
room::room
1997::1997
1996::1996
work::work
ms::ms
example::example
sinusoidal::sinusoidal
give::give
implementations::implementations
shelving::shelving
carriers::carriers
provide::provide
machine::machine
far::far
after::after
confirmed::confirmed
modest::modest
attempt::attempt
summing::summing
green::green
operate::operate
order::order
office::office
over::over
vary::vary
sickle::sickle
murray::murray
12.1::12.1
12.5::12.5
before::before
fittings::fittings
personal::personal
fix::fix
exhibits::exhibits
better::better
16.5::16.5
confidently::confidently
then::then
affected::affected
vouchers::vouchers
band::band
effects::effects
they::they
represents::represents
reasonable::reasonable
each::each
interfering::interfering
mean::mean
afforded::afforded
schemes::schemes
financial::financial
series::series
used::used
combining::combining
laboratory::laboratory
network::network
infrastructure-free::infrastructure-free
size::size
turning::turning
associate::associate
given::given
standard::standard
estimate::estimate
non-line-of-sight::non-line-of-sight
starts::starts
messages::messages
filter::filter
ism::ism
uses::uses
user::user
already::already
channels::channels
approximately::approximately
needed::needed
rates::rates
too::too
ranging::ranging
listen::listen
5-10::5-10
ceiling::ceiling
repeatable::repeatable
distance::distance
likely::likely
project::project
enables::enables
powers::powers
acquisition::acquisition
fashion::fashion
objects::objects
spectrum::spectrum
seen::seen
relatively::relatively
strength::strength
latter::latter
power-hungry::power-hungry
transmit::transmit
10hz::10hz
circles::circles
blue::blue
troughs::troughs
regular::regular
phase::phase
assessed::assessed
calculated::calculated
partition::partition
m::m
accounted::accounted
+::+
highly-accurate::highly-accurate
random::random
~10::~10
radio::radio
solutions::solutions
proposed::proposed
guidance::guidance
do::do
2408-2416::2408-2416
10::10
db::db
report::report
bat::bat
bar::bar
bae::bae
state-of-the-art::state-of-the-art
reference::reference
sensitivity::sensitivity
testing::testing
zones::zones
depends::depends
result::result
sporadic::sporadic
best::best
techniques::techniques
06::06
away::away
r::r
simplest::simplest
propagated::propagated
approach::approach
we::we
extend::extend
weak::weak
however::however
improve::improve
received::received
triggers::triggers
uncertainty::uncertainty
against::against
42-47::42-47
receiver::receiver
variance::variance
contribution::contribution
argue::argue
royal::royal
wider::wider
three::three
been::been
advert::advert
much::much
detrimental::detrimental
interest::interest
expected::expected
flexible::flexible
life::life
2426::2426
near-optimal::near-optimal
worked::worked
160::160
applied::applied
n::n
aim::aim
euclidean::euclidean
near::near
viii::viii
aid::aid
ix::ix
metropolitan::metropolitan
is::is
it::it
iv::iv
ii::ii
gnss+::gnss+
in::in
interacts::interacts
trusted::trusted
if::if
containing::containing
perform::perform
suggest::suggest
complex::complex
potentially::potentially
filtered::filtered
perimeter::perimeter
satellite::satellite
peaks::peaks
horus::horus
hand::hand
norwegian::norwegian
opportunity::opportunity
centred::centred
hopping::hopping
simulated::simulated
the::the
left::left
protocol::protocol
just::just
1hz::1hz
epochs::epochs
assigned::assigned
bandwidth::bandwidth
identify::identify
human::human
previous::previous
advertising/beaconing::advertising/beaconing
had::had
passive::passive
spread::spread
easy::easy
5g::5g
has::has
possible::possible
fusion::fusion
advanced::advanced
apart::apart
desire::desire
specific::specific
ph.d::ph.d
sparse::sparse
arbitrary::arbitrary
right::right
dimitri::dimitri
people::people
dead::dead
donald::donald
advertise::advertise
fingerprinting::fingerprinting
dense::dense
for::for
deploy::deploy
ubiquity::ubiquity
core::core
constructive::constructive
post::post
permitted::permitted
bahl::bahl
ranges::ranges
ensure::ensure
low-cost::low-cost
bound::bound
down::down
lies::lies
support::support
initial::initial
width::width
harle::harle
fraction::fraction
was::was
asset::asset
steers::steers
form::form
differences::differences
office/residential::office/residential
wireless::wireless
removed::removed
true::true
maximum::maximum
devices::devices
classic::classic
abstract::abstract
opportunistic::opportunistic
evidence::evidence
''::''
accounting::accounting
distributions::distributions
triangles::triangles
constructed::constructed
floor::floor
whereas::whereas
generally::generally
reality::reality
ny::ny
test::test
's::'s
uniformly::uniformly
miscellaneous::miscellaneous
scale::scale
jones::jones
faster::faster
assume::assume
interval::interval
together::together
time::time
varying::varying
leads::leads
3dbm::3dbm
inverse::inverse
technique::technique
environment::environment
division::division
smartphone::smartphone
advantage::advantage
frequencies::frequencies
sponsors::sponsors
choice::choice
exact::exact
minute::minute
partitions::partitions
level::level
anisotropy::anisotropy
standards::standards
p::p
quick::quick
slower::slower
penetrates::penetrates
uniform::uniform
current::current
international::international
unrestricted::unrestricted
satisfy::satisfy
-100::-100
understanding::understanding
smearing::smearing
6-8::6-8
alone::alone
along::along
appears::appears
noticeable::noticeable
institute::institute
vectors::vectors
commonly::commonly
simultaneous::simultaneous
usually::usually
navigation::navigation
windowing::windowing
plotted::plotted
useful::useful
extra::extra
bullock::bullock
flexibility::flexibility
rarely::rarely
working::working
first-bounce::first-bounce
frequency-dependent::frequency-dependent
properties::properties
andy::andy
iphone::iphone
introducing::introducing
``::``
apparent::apparent
maximise::maximise
downing::downing
degrade::degrade
adverts::adverts
pseudorandomly::pseudorandomly
mmse::mmse
values::values
can::can
following::following
location-based::location-based
nearest::nearest
reflector::reflector
figure::figure
nexus::nexus
attribute::attribute
sample::sample
performed::performed
allowed::allowed
occur::occur
pink::pink
requirements::requirements
divided::divided
s4::s4
1::1
rubin::rubin
optimal::optimal
map::map
may::may
applications::applications
mac::mac
produce::produce
designed::designed
such::such
destructive::destructive
data::data
ghz::ghz
switch::switch
so::so
typical::typical
wavelengths::wavelengths
unsolicited::unsolicited
displayed::displayed
years::years
course::course
experiments::experiments
motions::motions
still::still
ieee::ieee
monitor::monitor
acknowledge::acknowledge
decreases::decreases
window::window
offers::offers
2402::2402
half::half
not::not
now::now
matched::matched
turetzky::turetzky
realistic::realistic
micro-location::micro-location
individually::individually
domain::domain
square::square
significantly::significantly
populated::populated
gaussian::gaussian
year::year
wavelength::wavelength
shown::shown
space::space
interference::interference
increase::increase
contained::contained
investigation::investigation
individuallyinterfering::individuallyinterfering
ble::ble
receiving::receiving
sensor::sensor
shows::shows
inevitably::inevitably
theory::theory
wi-fi::wi-fi
training::training
locations::locations
transition::transition
motion::motion
518::518
routes::routes
first::first
constantly::constantly
kernel::kernel
waves::waves
one::one
50hz::50hz
fast::fast
message::message
open::open
engineer::engineer
little::little
2::2
editor::editor
way::way
that::that
continuous::continuous
alan::alan
broadcast::broadcast
mems::mems
representing::representing
than::than
11::11
wide::wide
13::13
12::12
14::14
16::16
19::19
require::require
future::future
were::were
and::and
gathering::gathering
turned::turned
argument::argument
occupied::occupied
any::any
efficient::efficient
note::note
ideal::ideal
potential::potential
take::take
online::online
interior::interior
performance::performance
channel::channel
multiple::multiple
track::track
importantly::importantly
queens::queens
26th::26th
considered::considered
average::average
steady::steady
senior::senior
typically::typically
precise::precise
walking::walking
shot::shot
show::show
discovered::discovered
threshold::threshold
ground::ground
slow::slow
3::3
only::only
black::black
seldom::seldom
median::median
paper::paper
predicted::predicted
where::where
ignored::ignored
thesis::thesis
ends::ends
attenuates::attenuates
college::college
surfaces::surfaces
detect::detect
ways::ways
subsequent::subsequent
sites::sites
enough::enough
between::between
across::across
infrastructure::infrastructure
gnss::gnss
awards::awards
20::20
concentrated::concentrated
many::many
region::region
hours::hours
machine-tomachine::machine-tomachine
propagation::propagation
s::s
filtering::filtering
period::period
exploit::exploit
learning::learning
68::68
considering::considering
millimetre::millimetre
combined::combined
enable::enable
formed::formed
readings::readings
observe::observe
external::external
bayesian::bayesian
careful::careful
former::former
case::case
developing::developing
these::these
profiles::profiles
80mhz::80mhz
conferences::conferences
coupled::coupled
characteristics::characteristics
metric::metric
agnostic::agnostic
technology::technology
different::different
verified::verified
media::media
same::same
epoch::epoch
events::events
week::week
investigated::investigated
boosted::boosted
driven::driven
running::running
advertisement::advertisement
relies::relies
tracking::tracking
no::no
severe::severe
without::without
coordinate::coordinate
model::model
consisted::consisted
being::being
when::when
nearme::nearme
speed::speed
halfway::halfway
trigger::trigger
except::except
improvement::improvement
4::4
samples::samples
around::around
early::early
predetermined::predetermined
grid::grid
using::using
postprocessed::postprocessed
recipient::recipient
furniture::furniture
reduces::reduces
faragher::faragher
benefit::benefit
retailers::retailers
output::output
reduced::reduced
simulator::simulator
canteen::canteen
provided::provided
dimensions::dimensions
recorded::recorded
provides::provides
moderate::moderate
ray-tracing::ray-tracing
power::power
communicate::communicate
update::update
notably::notably
padmanabhan::padmanabhan
refers::refers
comparison::comparison
of::of
estimator::estimator
or::or
cambridge::cambridge
beacons::beacons
communication::communication
image::image
copies::copies
low-power::low-power
references::references
determine::determine
area::area
assumed::assumed
there::there
hertz::hertz
detectable::detectable
low::low
2mhz::2mhz
positioned::positioned
posterior::posterior
technologies::technologies
with::with
longer::longer
datasets::datasets
moved::moved
deep::deep
general::general
as::as
at::at
walks::walks
moves::moves
again::again
beyond::beyond
ideally::ideally
thresholded::thresholded
valid::valid
5::5
spatial::spatial
poor::poor
separate::separate
suited::suited
experimentally-derived::experimentally-derived
building::building
wifi::wifi
original::original
represent::represent
all::all
caused::caused
batches::batches
tn::tn
to::to
batched::batched
presentation::presentation
returned::returned
very::very
coloured::coloured
fall::fall
difference::difference
dampen::dampen
large::large
cluttered::cluttered
small::small
grateful::grateful
sinusoid::sinusoid
rate::rate
perspective::perspective
further::further
dissertation::dissertation
section::section
navsop::navsop
version::version
cupboards::cupboards
acknowledgments::acknowledgments
movement::movement
full::full
behaviour::behaviour
beacon::beacon
selective::selective
operating::operating
i.e::i.e
allows::allows
experience::experience
prior::prior
advertising::advertising
narrow::narrow
options::options
vii::vii
indoors::indoors
chunks::chunks
readily::readily
wlan-based::wlan-based
contains::contains
two::two
ibeacon::ibeacon
6::6
taken::taken
more::more
erhorst::erhorst
tested::tested
particular::particular
known::known
mounted::mounted
producing::producing
science::science
equation::equation
base-10::base-10
v::v
compare::compare
mackay::mackay
scan::scan
share::share
states::states
minimum::minimum
station::station
information::information
needs::needs
rather::rather
algorithms::algorithms
maps::maps
explains::explains
csr::csr
mapping::mapping
reflect::reflect
coming::coming
metre-level::metre-level
a::a
shortcomings::shortcomings
short::short
roundtrip::roundtrip
broadcasting::broadcasting
radios::radios
september::september
developed::developed
soon::soon
disabled::disabled
radar::radar
scientist::scientist
through::through
its::its
chowdhary::chowdhary
rapidly::rapidly
22::22
susceptible::susceptible
solving::solving
detected::detected
systems::systems
might::might
good::good
propose::propose
reflected::reflected
walls::walls
found::found
repeating::repeating
referred::referred
energy::energy
reduce::reduce
idea::idea
expect::expect
measurement::measurement
skewed::skewed
event::event
dominates::dominates
robert::robert
since::since
research::research
dominated::dominated
7::7
smartslam::smartslam
offline::offline
issue::issue
occurs::occurs
doppler::doppler
generate::generate
pairs::pairs
positioning::positioning
conducted::conducted
w::w
probability::probability
number::number
construct::construct
introduction::introduction
least::least
assumption::assumption
calculations::calculations
dealing::dealing
compromise::compromise
scheme::scheme
jarvis::jarvis
gps::gps
part::part
authors::authors
recording::recording
determined::determined
randomly::randomly
pedestrian::pedestrian
fading::fading
paths::paths
depending::depending
also::also
internal::internal
wellsurveyed::wellsurveyed
towards::towards
measures::measures
most::most
75::75
significant::significant
measured::measured
deviations::deviations
mobile::mobile
4.4.4::4.4.4
clear::clear
4.4.2::4.4.2
traditional::traditional
reflections::reflections
velocity::velocity
physics::physics
particularly::particularly
hopper::hopper
fine::fine
networks::networks
impact::impact
cell::cell
parameters::parameters
distributed::distributed
8::8
circle::circle
proximity::proximity
his::his
spurious::spurious
during::during
remove::remove
transceivers::transceivers
investigate::investigate
infrastructure-based::infrastructure-based
locating::locating
scanning::scanning
bars::bars
set::set
achieved::achieved
see::see
are::are
close::close
institutes::institutes
2.6::2.6
2.4::2.4
visiting::visiting
currently::currently
won::won
various::various
consecutive::consecutive
conditions::conditions
available::available
targeted::targeted
nashville::nashville
relying::relying
both::both
c::c
improves::improves
whole::whole
experimental::experimental
point::point
battery::battery
throughout::throughout
belt::belt
pp::pp
described::described
enhancements::enhancements
conveyor::conveyor
due::due
reduction::reduction
maintenance::maintenance
collected::collected
meeting::meeting
leimer::leimer
precision::precision
determination::determination
representative::representative
look::look
indefinitely::indefinitely
straight::straight
batch::batch
pace::pace
while::while
reliably::reliably
error::error
30::30
vol::vol
37::37
lengthy::lengthy
baseline::baseline
shorter::shorter
corridor::corridor
9::9
survey::survey
higher::higher
magnetometer::magnetometer
attenuation::attenuation
levels::levels
moving::moving
appreciable::appreciable
recent::recent
lower::lower
studies::studies
energy-efficient::energy-efficient
spent::spent
analysis::analysis
segmented::segmented
gsm::gsm
2.48ghz::2.48ghz
distances::distances
observed::observed
shape::shape
inference::inference
apple::apple
extracted::extracted
advertisements::advertisements
signals::signals
source::source
1006-1019::1006-1019
location::location
input::input
sightings::sightings
matters::matters
d::d
follows::follows
signal::signal
communications::communications
r.k::r.k
often::often
r.m::r.m
some::some
back::back
metres::metres
strongest::strongest
sight::sight
oscillations::oscillations
and/or::and/or
affects::affects
measurements::measurements
per::per
minimal::minimal
be::be
processing::processing
use::use
stem::stem
lasts::lasts
by::by
usa::usa
constraint::constraint
simulation::simulation
range::range
into::into
within::within
appropriate::appropriate
primarily::primarily
resilience::resilience
placing::placing
specifically::specifically
an::an
great::great
line::line
youssef::youssef
deployed::deployed
fades::fades
up::up
us::us
windows::windows
uk::uk
fluctuations::fluctuations
similar::similar
associated::associated
single::single
fast-fade::fast-fade
defines::defines
%::%
cell-ids::cell-ids
priors::priors
end::end
points::points
users::users
generated::generated
reflectors::reflectors
correlated::correlated
algorithm::algorithm
complicating::complicating
required::required
walked::walked
2002::2002
depth::depth
2004::2004
2009::2009
requires::requires
having::having
once::once
illustrates::illustrates
results::results
existing::existing
amplified::amplified
issues::issues
3hz::3hz
rollout::rollout
stable::stable
suite::suite
maryland::maryland
include::include
dramatically::dramatically
continues::continues
cellular::cellular
entire::entire
single-reflection::single-reflection
transmission::transmission
positions::positions
reinoud::reinoud
smaller::smaller
unavailable::unavailable
apparatus::apparatus
-20::-20
access::access
experiment::experiment
;::;
3d::3d
body::body
led::led
chose::chose
respectively::respectively
high-accuracy::high-accuracy
commercial::commercial
desired::desired
ramsey::ramsey
separation::separation
consideration::consideration
extreme::extreme
39::39
38::38
technical::technical
larger::larger
metre::metre
suggests::suggests
resulting::resulting
makes::makes
addresses::addresses
scales::scales
greg::greg
confidence::confidence
from::from
consumption::consumption
&::&
few::few
milliseconds::milliseconds
on::on
labelled::labelled
iii::iii
account::account
portability::portability
this::this
challenge::challenge
anywhere::anywhere
drops::drops
process::process
0.5::0.5
purposes::purposes
high::high
effectively::effectively
pulling::pulling
connectable::connectable
located::located
varies::varies
sig::sig
instead::instead
allow::allow
attenuator::attenuator
insight::insight
produced::produced
including::including
referencing::referencing
beaconing::beaconing
lg::lg
blake::blake
choose::choose
bye::bye
2010::2010
2013::2013
2012::2012
greater::greater
practice::practice
gnss-denied::gnss-denied
mitigated::mitigated
fingerprint::fingerprint
transmitter::transmitter
university::university
magnitude::magnitude
mode::mode
truth::truth
overspecified::overspecified
identifier::identifier
constraints::constraints
bluetooth::bluetooth
frequency::frequency
static::static
our::our
80::80
out::out
obstructions::obstructions
posteriori::posteriori
cause::cause
red::red
completely::completely
york::york
likelihood::likelihood
geometry::geometry
could::could
times::times
length::length
explored::explored
hence::hence
transmitters::transmitters
re-surveying::re-surveying
long::long
system::system
unspecified::unspecified
their::their
travelled::travelled
adopts::adopts
interests::interests
environmental::environmental
reflecting::reflecting
45m::45m
19-beacon::19-beacon
rss::rss
detection::detection
amplitude::amplitude
providing::providing
exhibit::exhibit
hz::hz
ultrasonic::ultrasonic
have::have
need::need
which::which
=::=
accuracy::accuracy
lecturer::lecturer
centre::centre
who::who
pausing::pausing
device::device
why::why
centimetres::centimetres
gather::gather
proceedings::proceedings
databases::databases
fact::fact
dbm::dbm
indoor::indoor
12m::12m
principal::principal
nominally::nominally
based::based
2480::2480
should::should
ambiguity::ambiguity
he::he
hope::hope
=1::=1
means::means
overall::overall
october::october
drawn::drawn
processes::processes
evident::evident
fixes::fixes
multimodality::multimodality
tuner::tuner
cycles::cycles
monochromatic::monochromatic
official::official
exists::exists
correlations::correlations
computer::computer
usefulness::usefulness
multipath::multipath
record::record
pattern::pattern
tend::tend
comparable::comparable
ability::ability
interfere::interfere
key::key
problem::problem
thumb::thumb
limits::limits
career::career
freely::freely
taking::taking
etc::etc
estimation::estimation
cm::cm
wall::wall
environments::environments
walk::walk
dependent::dependent
2000::2000
8.5::8.5
geometries::geometries
broadcasts::broadcasts
20hz::20hz
slowly::slowly
outliers::outliers
corresponding::corresponding
route::route
coherence::coherence
fellow::fellow
present::present
smartphones::smartphones
unlike::unlike
balachandran::balachandran
value::value
will::will
manually::manually
vi::vi
thus::thus
surface::surface
hardware::hardware
examined::examined
regression::regression
cross::cross
highlighted::highlighted
units::units
android::android
multi-modal::multi-modal
0.1::0.1
ios::ios
effect::effect
ion::ion
android-based::android-based
identity::identity
4.0::4.0
off::off
reflection::reflection
i::i
colour::colour
well::well
position::position
sensing::sensing
latest::latest
less::less
accurate::accurate
sources::sources
underlying::underlying
distant::distant
rapid::rapid
density::density
logged::logged
capabilities::capabilities
simple::simple
add::add
attractive::attractive
tests::tests
masters::masters
increases::increases
deployment::deployment
press::press
loss::loss
necessary::necessary
like::like
sizes::sizes
exploiting::exploiting
fingerprints::fingerprints
mhz::mhz
become::become
deviation::deviation
exceed::exceed
because::because
smoothly::smoothly
phenomena::phenomena
demonstrates::demonstrates
avoid::avoid
overlap::overlap
does::does
assuming::assuming
demonstrated::demonstrated
locate::locate
noise::noise
conveyer::conveyer
real-world::real-world
journal::journal
although::although
about::about
carried::carried
reckoning::reckoning
coverage::coverage
bssid::bssid
previously::previously
assess::assess
weighted::weighted
promise::promise
estimators::estimators
additional::additional
smoothing::smoothing
mitigation::mitigation
function::function
but::but
volume::volume
repeated::repeated
construction::construction
non-connectable::non-connectable
made::made
places::places
whether::whether
cells::cells
j::j
smooth::smooth
placed::placed
below::below
distribution::distribution
co-located::co-located
handset::handset
compared::compared
45::45
40::40
other::other
mahesh::mahesh
conclusion::conclusion
repeat::repeat
variation::variation
chance::chance
samsung::samsung
factors::factors
rule::rule
intentionally::intentionally
lives::lives
