::
limited::limited
desirable::desirable
circuitry::circuitry
sleep::sleep
presents::presents
fine-grained::fine-grained
under::under
summarizes::summarizes
@::@
data.8::data.8
every::every
tagging::tagging
companies::companies
solution::solution
multi-camera::multi-camera
convenience::convenience
vector::vector
falco::falco
rfmonolithics::rfmonolithics
coordinate::coordinate
phones::phones
consistent::consistent
direct::direct
surrounding::surrounding
likely::likely
implemented::implemented
even::even
established::established
specification::specification
adhoc::adhoc
above::above
frank::frank
new::new
here::here
granularity::granularity
active::active
path::path
k::k
permit::permit
suitable::suitable
changes::changes
mobility::mobility
explained::explained
replace::replace
total::total
would::would
chooses::chooses
call::call
therefore::therefore
type::type
until::until
aware::aware
phone::phone
excellent::excellent
serially::serially
circumstances::circumstances
1992::1992
ma::ma
room::room
1997::1997
1999::1999
1998::1998
setup::setup
work::work
rulings::rulings
worn::worn
tr1000::tr1000
batteries/holders::batteries/holders
petersen::petersen
example::example
infrared-based::infrared-based
household::household
organized::organized
implementations::implementations
aaaa::aaaa
want::want
absolute::absolute
68k::68k
provide::provide
travel::travel
machine::machine
how::how
nontrivial::nontrivial
answer::answer
turk::turk
after::after
lab::lab
0.0236::0.0236
summarize::summarize
types::types
attempt::attempt
ultimate::ultimate
deathstar::deathstar
ethernet::ethernet
operate::operate
order::order
operations::operations
office::office
over::over
vary::vary
thesis::thesis
keyboard::keyboard
japan::japan
pcmcia::pcmcia
before::before
writing::writing
better::better
production::production
then::then
them::them
9::9
they::they
1.00::1.00
lithium::lithium
reasonable::reasonable
each::each
technology.4::technology.4
side::side
voxel::voxel
principles::principles
used::used
laboratory::laboratory
extract::extract
networked::networked
network::network
quantify::quantify
cameras::cameras
rx::rx
content::content
pinpointcos::pinpointcos
rf::rf
reader::reader
stamping::stamping
little::little
sensors::sensors
94304::94304
logging::logging
inexpensive::inexpensive
incorporated::incorporated
uses::uses
user::user
cs.washington.edu::cs.washington.edu
already::already
features::features
primary::primary
customization::customization
service::service
similarly::similarly
0.00::0.00
approximately::approximately
needed::needed
too::too
cabling::cabling
ranging::ranging
pinpointing::pinpointing
ceiling::ceiling
enhancing::enhancing
esoteric::esoteric
predictable::predictable
somewhat::somewhat
distance::distance
second::second
regulator::regulator
historical::historical
boston::boston
manner::manner
seen::seen
seem::seem
relatively::relatively
strength::strength
firmware::firmware
transmit::transmit
though::though
object::object
optimized::optimized
involving::involving
coin::coin
inconsistency::inconsistency
partition::partition
m::m
points::points
tech::tech
consumer::consumer
+::+
incorporate::incorporate
random::random
infrared::infrared
implying::implying
attempts::attempts
radio::radio
solutions::solutions
participate::participate
lessons::lessons
implementation::implementation
integrate::integrate
adequate::adequate
do::do
4.00::4.00
wide::wide
scalable::scalable
report::report
15::15
onboard::onboard
unfortunately::unfortunately
architecture::architecture
automatic::automatic
zoran::zoran
reference::reference
w/::w/
sensitivity::sensitivity
detection::detection
radius::radius
result::result
p95-00050::p95-00050
best::best
techniques::techniques
away::away
r::r
previous::previous
approach::approach
we::we
terms::terms
wa::wa
however::however
suggested::suggested
hours::hours
conclusions::conclusions
beacon::beacon
login::login
location-sensing::location-sensing
guis::guis
starlink::starlink
three::three
been::been
commission::commission
much::much
interest::interest
basic::basic
expected::expected
flexible::flexible
website::website
life::life
immersive::immersive
air::air
ceilings::ceilings
goldberg::goldberg
ip::ip
is::is
ir::ir
it::it
characterize::characterize
in::in
comparative::comparative
seattle::seattle
id::id
sever::sever
if::if
gaetano::gaetano
perform::perform
make::make
potentially::potentially
several::several
fairly::fairly
satellite::satellite
nic::nic
hand::hand
fuse::fuse
off-the-shelf::off-the-shelf
shortly::shortly
spacetime::spacetime
client::client
simulated::simulated
3-axis::3-axis
the::the
left::left
protocol::protocol
photo::photo
laptop::laptop
thanks::thanks
yet::yet
jumpers::jumpers
visualization::visualization
unique::unique
had::had
n::n
board::board
easy::easy
has::has
gave::gave
hightower::hightower
possible::possible
fusion::fusion
background::background
partridge::partridge
depicts::depicts
disadvantage::disadvantage
coarseness::coarseness
50::50
ph.d::ph.d
steps::steps
admittedly::admittedly
security::security
facets::facets
right::right
people::people
successfully::successfully
zoom::zoom
meters::meters
tracked::tracked
for::for
ics::ics
repository::repository
arbitrary::arbitrary
popovic::popovic
illustration::illustration
architectural::architectural
post::post
manufacturing::manufacturing
emits::emits
bahl::bahl
plug::plug
limitation::limitation
o::o
slightly::slightly
microwebserver::microwebserver
xyz::xyz
rendering::rendering
bats::bats
phase.7::phase.7
probability.6::probability.6
rely::rely
support::support
initial::initial
approximate::approximate
way::way
was::was
calm::calm
questionable::questionable
26-28::26-28
form::form
offer::offer
something::something
wireless::wireless
bern::bern
bounds::bounds
devices::devices
8-bit::8-bit
emit::emit
3.3::3.3
3.50::3.50
computing::computing
abstract::abstract
evidence::evidence
exist::exist
promised::promised
harter::harter
physical::physical
no::no
when::when
reality::reality
leds::leds
shrink::shrink
's::'s
felt::felt
popavic::popavic
together::together
well-designed::well-designed
time::time
hill-climbing::hill-climbing
concept::concept
managed::managed
global::global
drop-off::drop-off
switches::switches
roy::roy
computation::computation
5.62::5.62
certainly::certainly
inverse::inverse
depend::depend
4.781::4.781
flash::flash
b.schilit::b.schilit
environment::environment
0::0
finally::finally
must::must
accelerometers::accelerometers
advantage::advantage
orthogonal::orthogonal
anonymous::anonymous
1995::1995
1994::1994
short-range::short-range
presented::presented
did::did
leave::leave
p::p
perceptual::perceptual
0.629::0.629
upper::upper
prediction::prediction
d::d
cost::cost
port::port
assistance::assistance
uniform::uniform
current::current
badge::badge
supporting::supporting
groups::groups
address::address
alone::alone
rs232::rs232
change::change
alto::alto
usually::usually
navigation::navigation
adjustable::adjustable
inference::inference
extra::extra
overarching::overarching
marker::marker
market::market
or::or
working::working
msr::msr
gibbons::gibbons
connector::connector
handles::handles
memory::memory
associated::associated
chapter::chapter
acceptable::acceptable
effort::effort
capturing::capturing
tokyo::tokyo
longitude::longitude
values::values
can::can
following::following
claim::claim
figure::figure
december::december
agent::agent
sample::sample
occur::occur
requirements::requirements
winter::winter
tilt::tilt
1::1
fourth::fourth
product::product
laundry::laundry
may::may
applications::applications
produce::produce
designed::designed
such::such
j.h::j.h
data::data
db9::db9
ss::ss
rather::rather
annealing::annealing
so::so
definitions::definitions
se::se
tagged::tagged
badge.11::badge.11
years::years
course::course
experiments::experiments
motions::motions
still::still
pointer::pointer
supplemented::supplemented
group::group
monitor::monitor
interesting::interesting
msr-tr-99-12::msr-tr-99-12
coordinates::coordinates
offers::offers
policy::policy
marshall::marshall
portolano::portolano
//www.cs.washington.edu/research/portolano/hydra/:://www.cs.washington.edu/research/portolano/hydra/
warranted::warranted
symposium::symposium
not::not
now::now
discuss::discuss
nor::nor
term::term
name::name
january::january
possibilities::possibilities
meters.1::meters.1
square::square
kang::kang
ez::ez
ft::ft
10-bit::10-bit
ep::ep
living::living
ultimately::ultimately
environments.10::environments.10
finegrained::finegrained
space::space
furthermore::furthermore
calls.9::calls.9
interference::interference
increase::increase
investigation::investigation
squares::squares
sensor::sensor
shows::shows
mechanisms::mechanisms
quite::quite
advantages::advantages
card::card
fixed::fixed
motion::motion
place::place
antenna::antenna
//www.fcc.gov/e911/:://www.fcc.gov/e911/
first::first
saving::saving
omitted::omitted
symbolic::symbolic
one::one
array::array
size::size
given::given
indicate::indicate
2::2
typing::typing
bits::bits
mostly::mostly
that::that
continuous::continuous
accurately::accurately
mems::mems
undoubtedly::undoubtedly
than::than
11::11
relative::relative
13::13
12::12
impractical::impractical
14::14
17::17
16::16
18::18
future::future
multithreaded::multithreaded
were::were
and::and
dynamically::dynamically
sells::sells
any::any
conversion::conversion
1/32::1/32
efficient::efficient
note::note
ideal::ideal
animation::animation
take::take
online::online
multibit::multibit
strengths::strengths
multiple::multiple
normal::normal
track::track
fcc::fcc
printed::printed
average::average
//www.rfideas.com/:://www.rfideas.com/
quantity::quantity
precise::precise
30-40::30-40
slot::slot
slow::slow
ratio::ratio
enough::enough
only::only
taxonomy::taxonomy
awareness::awareness
2mb::2mb
nearly::nearly
2mm::2mm
reveal::reveal
yield::yield
predicted::predicted
mapped::mapped
rs-232::rs-232
where::where
vision::vision
borriello::borriello
burst::burst
physically::physically
dragonball::dragonball
collects::collects
ieee::ieee
surfaces::surfaces
tackling::tackling
federal::federal
review::review
3::3
conferencing::conferencing
arrival::arrival
infrastructure::infrastructure
receivers::receivers
screen::screen
come::come
pass-through::pass-through
many::many
enabling::enabling
propagation::propagation
s::s
comes::comes
1m3::1m3
sampling::sampling
60::60
moreover::moreover
combines::combines
configuration::configuration
accelerometer::accelerometer
locally::locally
workshop::workshop
2mhz::2mhz
featuring::featuring
prototype::prototype
enable::enable
careful::careful
realities::realities
those::those
case::case
developing::developing
these::these
mount::mount
single::single
transactions::transactions
promising::promising
investigating::investigating
vest::vest
orientation::orientation
telephone::telephone
technology::technology
different::different
develop::develop
media::media
locking::locking
same::same
authentication::authentication
streams::streams
pan::pan
breakdown::breakdown
jeffrey::jeffrey
driver::driver
transceiver::transceiver
running::running
tracking::tracking
theater::theater
minimize::minimize
floor::floor
roughly::roughly
without::without
solve::solve
components::components
peripherals::peripherals
model::model
dimension::dimension
summer::summer
being::being
captures::captures
adjustments::adjustments
valuable::valuable
speed::speed
captured::captured
desktop::desktop
instrument::instrument
4::4
//www.research.microsoft.com/easyliving/:://www.research.microsoft.com/easyliving/
real::real
aspects::aspects
around::around
represents::represents
grid::grid
world::world
adams::adams
server::server
benefit::benefit
t::t
12.53::12.53
twelve::twelve
piezo::piezo
2d::2d
dimensions::dimensions
critical::critical
provides::provides
911::911
power::power
seconds::seconds
padmanabhan::padmanabhan
found::found
roaming::roaming
on::on
central::central
of::of
discussed::discussed
acm::acm
practical::practical
obeys::obeys
act::act
doze::doze
processor::processor
cambridge::cambridge
determine::determine
conceptually::conceptually
technically::technically
her::her
opengl::opengl
there::there
start::start
low::low
combined::combined
complete::complete
technologies::technologies
with::with
october::october
embedded::embedded
attenuate::attenuate
certain::certain
moved::moved
an::an
as::as
reliability::reliability
at::at
film::film
4.5::4.5
4.4::4.4
4.1::4.1
4.3::4.3
4.2::4.2
hybrid::hybrid
field::field
5::5
10::10
briefly::briefly
separate::separate
drift::drift
representable::representable
carnegie::carnegie
researchs::researchs
important::important
peak::peak
suited::suited
conclusive::conclusive
building::building
subdivision::subdivision
resolution::resolution
all::all
consider::consider
generalize::generalize
follow::follow
tx::tx
-l::-l
to::to
program::program
//www.pinpointco.com/:://www.pinpointco.com/
straightforward::straightforward
very::very
difference::difference
list::list
triangulate::triangulate
large::large
small::small
abstracted::abstracted
rate::rate
design::design
further::further
canonical::canonical
what::what
sub::sub
section::section
brief::brief
learned::learned
method::method
edited::edited
full::full
tags::tags
rudimentary::rudimentary
component::component
codebase::codebase
parctab::parctab
directions::directions
configurability::configurability
search::search
bible::bible
compliance::compliance
allows::allows
experience::experience
periodic::periodic
published::published
action::action
via::via
basestations::basestations
indoors::indoors
appliances::appliances
spawned::spawned
readily::readily
distinct::distinct
two::two
6::6
taken::taken
minor::minor
more::more
mellon::mellon
company::company
controlling::controlling
particular::particular
known::known
mounted::mounted
vp::vp
none::none
science::science
equation::equation
indicating::indicating
v::v
omit::omit
autumn::autumn
minimum::minimum
numbers::numbers
sense::sense
axis::axis
information::information
needs::needs
goal::goal
cse::cse
maps::maps
ubiquitous::ubiquitous
w::w
derived::derived
mapping::mapping
connectivity::connectivity
lighting::lighting
a::a
workstation::workstation
perhaps::perhaps
fundamental::fundamental
geographic::geographic
playing::playing
aided::aided
developed::developed
radar::radar
paper::paper
through::through
concentric::concentric
its::its
20::20
actually::actually
systems::systems
might::might
pcs.5::pcs.5
someone::someone
return::return
framework::framework
foot::foot
speculate::speculate
easily::easily
level::level
capability::capability
inherent::inherent
ports::ports
status::status
another::another
generation::generation
hard::hard
idea::idea
deployable::deployable
measurement::measurement
operation::operation
event::event
initiatives::initiatives
20.3::20.3
since::since
publish::publish
research::research
7::7
issue::issue
polling::polling
upon::upon
3.00::3.00
difficulty::difficulty
base::base
imagine::imagine
ask::ask
definition::definition
computers::computers
positioning::positioning
circuit::circuit
misc::misc
number::number
instances::instances
98195::98195
least::least
miss::miss
differ::differ
leverage::leverage
introduction::introduction
construct::construct
station::station
store::store
gps::gps
parc::parc
immediate::immediate
part::part
believe::believe
center::center
albeit::albeit
b::b
grained::grained
3.3.3::3.3.3
3.3.2::3.3.2
3.3.4::3.3.4
s.r::s.r
debugging::debugging
zyda::zyda
built::built
majority::majority
costs::costs
build::build
microwebserver12::microwebserver12
added::added
populate::populate
chart::chart
most::most
significant::significant
services::services
mobile::mobile
traditional::traditional
caching::caching
2.00::2.00
microsoft::microsoft
gold::gold
commissions::commissions
hopper::hopper
360-degree::360-degree
fine::fine
parameters::parameters
heavily::heavily
distributed::distributed
factor::factor
8::8
circle::circle
accurate::accurate
his::his
connections::connections
during::during
boost::boost
remove::remove
transceivers::transceivers
mouse-based::mouse-based
set::set
parc.xerox.com::parc.xerox.com
mediacells::mediacells
are::are
2.2::2.2
2.1::2.1
constellation::constellation
3.3.1::3.3.1
#::#
probable::probable
movie::movie
currently::currently
various::various
probably::probably
available::available
recently::recently
creating::creating
interfaces::interfaces
scalability::scalability
poorer::poorer
msr-tr98-69::msr-tr98-69
invisible::invisible
both::both
last::last
sensitive::sensitive
context::context
load::load
consume::consume
point::point
simple::simple
dimensional::dimensional
simply::simply
throughout::throughout
expensive::expensive
pr::pr
pp::pp
described::described
publishing::publishing
create::create
describes::describes
180mah::180mah
gas::gas
georgia::georgia
reliable::reliable
empirical::empirical
iodes::iodes
while::while
optimization::optimization
reliably::reliably
error::error
loop::loop
larger::larger
century::century
vol::vol
jeffro::jeffro
puis::puis
estimate::estimate
widely::widely
modification::modification
development::development
attenuation::attenuation
moving::moving
purpose::purpose
robust::robust
lower::lower
task::task
analysis::analysis
person::person
distances::distances
semi-reliable::semi-reliable
tasks::tasks
3d-id::3d-id
using::using
useful::useful
50.7::50.7
ultrasonics::ultrasonics
$::$
kluwer::kluwer
also::also
signals::signals
location::location
input::input
transformation::transformation
march::march
emergency::emergency
aggregation::aggregation
bit::bit
cognitive::cognitive
follows::follows
signal::signal
communications::communications
essential::essential
mathematical::mathematical
often::often
creation::creation
some::some
back::back
prototyping::prototyping
3.4::3.4
3.2::3.2
examples::examples
palo::palo
3.1::3.1
measurements::measurements
integration::integration
per::per
proc::proc
augmenting::augmenting
either::either
be::be
run::run
anecdotes::anecdotes
processing::processing
triangulates::triangulates
step::step
by::by
standalone::standalone
range::range
into::into
within::within
spread-spectrum::spread-spectrum
primarily::primarily
acknowledgements::acknowledgements
hydra::hydra
cambridge.2::cambridge.2
placing::placing
question::question
long::long
custom::custom
1.50::1.50
analyze::analyze
sections::sections
record::record
inches::inches
properly::properly
migrating::migrating
info::info
//www.starlinkdgps.com/dgpsexp.htm:://www.starlinkdgps.com/dgpsexp.htm
intuitive::intuitive
circuits::circuits
uw::uw
up::up
us::us
heterogeneous::heterogeneous
similar::similar
called::called
constant::constant
defined::defined
influence::influence
globally::globally
engineering::engineering
diverse::diverse
surveying::surveying
%::%
application::application
revision::revision
dgps::dgps
users::users
provided::provided
aggregates::aggregates
generated::generated
allowing::allowing
dram::dram
algorithm::algorithm
required::required
notion::notion
2000::2000
far::far
requires::requires
receive::receive
once::once
code::code
aggregating::aggregating
results::results
existing::existing
go::go
query::query
issues::issues
seemed::seemed
compact::compact
concerned::concerned
pinpointco::pinpointco
include::include
r.want::r.want
sent::sent
ingredient::ingredient
cellular::cellular
categories::categories
entire::entire
positions::positions
49.5::49.5
stddev::stddev
prototyped::prototyped
configurations::configurations
locate::locate
video::video
manipulating::manipulating
cinematographic::cinematographic
multi-floored::multi-floored
multimedia::multimedia
cell::cell
consistently::consistently
pui::pui
experiment::experiment
microprocessor::microprocessor
folks::folks
3d::3d
body::body
focuses::focuses
led::led
degree::degree
exchange::exchange
commercial::commercial
brutzman::brutzman
desired::desired
objects::objects
focused::focused
internetworking::internetworking
settling::settling
technical::technical
30::30
survey::survey
implement::implement
purview::purview
nearest::nearest
context-aware::context-aware
spoton::spoton
addressed::addressed
api::api
apply::apply
basestation::basestation
boasts::boasts
use::use
from::from
usb::usb
consumption::consumption
&::&
next::next
few::few
camera::camera
trail::trail
43.8::43.8
topic::topic
this::this
e911::e911
1.49::1.49
fulfill::fulfill
proof::proof
control::control
xmit::xmit
providers::providers
process::process
effectively::effectively
tag::tag
archetypal::archetypal
serial::serial
located::located
instead::instead
intelligent::intelligent
buildings::buildings
efficiently::efficiently
light::light
lines::lines
integrator/::integrator/
element::element
allow::allow
a/d::a/d
insight::insight
meter::meter
including::including
mentioned::mentioned
badges::badges
chosen::chosen
labor::labor
choose::choose
latitude::latitude
<::<
auto-logon::auto-logon
45-101::45-101
satellites::satellites
articles::articles
february::february
university::university
read/write::read/write
mode::mode
cdma-like::cdma-like
identifier::identifier
related::related
frequency::frequency
dram/flash::dram/flash
measure::measure
our::our
out::out
mediated::mediated
electronics::electronics
integrated::integrated
retrieved::retrieved
approaches::approaches
determining::determining
could::could
area::area
length::length
explored::explored
isbn::isbn
resistors/caps/d::resistors/caps/d
precisely::precisely
rfideas::rfideas
management::management
privacy::privacy
unknown::unknown
system::system
their::their
wrapped::wrapped
completed::completed
observed::observed
limiting::limiting
providing::providing
weiser::weiser
ultrasonic::ultrasonic
have::have
need::need
constrained::constrained
demonstration::demonstration
clearly::clearly
acceleration::acceleration
documents::documents
angle::angle
minimally::minimally
able::able
mechanism::mechanism
tomasz::tomasz
mix::mix
concerns::concerns
which::which
detector::detector
=::=
accuracy::accuracy
worldwide::worldwide
imielinski::imielinski
connected::connected
representation::representation
why::why
stereo::stereo
placement::placement
request::request
outfit::outfit
proceedings::proceedings
j.ellis::j.ellis
fact::fact
goals::goals
indoor::indoor
anyway::anyway
trivial::trivial
based::based
should::should
buttons::buttons
employed::employed
achieve::achieve
move::move
means::means
overall::overall
120::120
areas::areas
differential::differential
cycles::cycles
view::view
conform::conform
computed::computed
configured::configured
in-building::in-building
packet::packet
operates::operates
computer::computer
enhanced::enhanced
closer::closer
attempting::attempting
arguably::arguably
state::state
progress::progress
variability::variability
ability::ability
efficiency::efficiency
916.5mhz::916.5mhz
key::key
hands-free::hands-free
commands::commands
presentations::presentations
etc::etc
grain::grain
0-7923-9697-9::0-7923-9697-9
relevant::relevant
conclude::conclude
ca::ca
packaging::packaging
interface::interface
adjuster::adjuster
2000-02-02::2000-02-02
li::li
addition::addition
decent::decent
data-store::data-store
directionality.3::directionality.3
sufficient::sufficient
sensed::sensed
general::general
present::present
laser::laser
virtual::virtual
value::value
will::will
almost::almost
thus::thus
site::site
hardware::hardware
vr::vr
4.50::4.50
capture::capture
generic::generic
began::began
highlighted::highlighted
parts::parts
speaker::speaker
units::units
0.1::0.1
ball::ball
http::http
1-5::1-5
automation::automation
architectures::architectures
contribution::contribution
identity::identity
reflection::reflection
acknowledgement::acknowledgement
well::well
1-2hz::1-2hz
command::command
position::position
audio::audio
sensing::sensing
less::less
proximity::proximity
sources::sources
batteries::batteries
rooms::rooms
15.64::15.64
wavelan::wavelan
logged::logged
battery::battery
book::book
smart::smart
tests::tests
transmitter::transmitter
increases::increases
necessary::necessary
exploiting::exploiting
grain-size::grain-size
works::works
because::because
sequence::sequence
home::home
pinpoint::pinpoint
does::does
assuming::assuming
leverages::leverages
?::?
limitations::limitations
noise::noise
although::although
about::about
actual::actual
boards::boards
extension::extension
25.6::25.6
locationsensing::locationsensing
software::software
outset::outset
own::own
previously::previously
washington::washington
mere::mere
2.50::2.50
networking::networking
*::*
9.1::9.1
function::function
bus::bus
xerox::xerox
but::but
repeated::repeated
construction::construction
system.13::system.13
convergence::convergence
made::made
compute::compute
converter::converter
whether::whether
wish::wish
cells::cells
j::j
variations::variations
placed::placed
below::below
problem::problem
display::display
recognize::recognize
functions::functions
nonetheless::nonetheless
40::40
illinois::illinois
other::other
shown::shown
91-102::91-102
0.50::0.50
