::
represent::represent
all::all
global::global
focus::focus
four::four
grateful::grateful
perturbations::perturbations
compares::compares
issues::issues
inverse::inverse
concerned::concerned
technique::technique
removal::removal
environment::environment
to::to
those::those
th::th
under::under
stochastic::stochastic
nodes::nodes
@::@
performs::performs
very::very
mn1::mn1
mn2::mn2
rise::rise
springer::springer
results::results
-70::-70
every::every
1067-1080::1067-1080
li::li
obvious::obvious
caminada::caminada
evaluation::evaluation
standards::standards
large::large
this::this
phase::phase
small::small
thiago::thiago
concluded::concluded
limitations::limitations
employing::employing
ulster::ulster
literature::literature
d::d
surrounding::surrounding
second::second
100msec::100msec
follow::follow
telecommunication::telecommunication
universities::universities
non-los::non-los
plays::plays
section::section
access::access
version::version
5-second::5-second
international::international
increasing::increasing
ever::ever
method::method
body::body
smailagic::smailagic
transportation::transportation
lee::lee
degree::degree
exchange::exchange
respectively::respectively
reported::reported
beacon::beacon
objects::objects
directions::directions
based::based
november::november
quite::quite
obtained::obtained
33::33
32::32
employees::employees
funded::funded
commonly::commonly
34::34
significantly::significantly
suggests::suggests
periodic::periodic
survey::survey
weekday::weekday
published::published
makes::makes
composed::composed
deterministic::deterministic
mobility::mobility
aps::aps
analyzing::analyzing
aimed::aimed
trained::trained
kogan::kogan
datasets::datasets
intensive::intensive
use::use
from::from
would::would
&::&
one-point::one-point
chi::chi
give::give
two::two
next::next
few::few
opposed::opposed
leopoldo::leopoldo
6::6
taken::taken
overviews::overviews
assessment::assessment
7ft::7ft
more::more
ap2::ap2
ap1::ap1
site::site
visual::visual
8::8
known::known
iii::iii
must::must
account::account
f::f
1999::1999
iee::iee
setup::setup
rudys::rudys
reviews::reviews
values::values
can::can
ms::ms
freedom::freedom
following::following
conformity::conformity
example::example
regularly::regularly
compare::compare
wang::wang
figure::figure
activities::activities
discussed::discussed
distributions::distributions
organized::organized
purposes::purposes
high::high
minimum::minimum
performed::performed
employs::employs
made::made
information::information
needs::needs
end::end
hoc::hoc
provide::provide
discussion::discussion
holds::holds
vehicular::vehicular
trilateration::trilateration
1::1
vital::vital
phd::phd
widespread::widespread
constraints::constraints
intelligent::intelligent
map::map
lan::lan
sumana::sumana
may::may
kaist::kaist
earlier::earlier
applications::applications
designed::designed
fits::fits
such::such
horizontal::horizontal
data::data
man::man
a::a
changes::changes
effective::effective
light::light
register::register
yielding::yielding
maintain::maintain
algorithms::algorithms
allow::allow
media::media
ethernet::ethernet
operate::operate
order::order
typical::typical
help::help
office::office
over::over
entity::entity
paper::paper
*corresponding::*corresponding
innovative::innovative
mentioned::mentioned
still::still
ieee::ieee
its::its
20::20
conducted::conducted
fit::fit
personal::personal
procedures::procedures
temporal::temporal
wallach::wallach
decreases::decreases
labor::labor
finger-printing::finger-printing
platform::platform
barnes::barnes
systems::systems
main::main
2011::2011
2010::2010
2012::2012
then::then
affected::affected
geographical::geographical
matches::matches
number::number
jiyun::jiyun
they::they
das::das
not::not
uncontrolled::uncontrolled
discuss::discuss
developments::developments
deteriorates::deteriorates
airports::airports
name::name
fully::fully
university::university
l::l
2d::2d
unpredictable::unpredictable
transmitted::transmitted
mode::mode
reasonable::reasonable
each::each
accommodated::accommodated
identifies::identifies
referred::referred
square::square
p::p
primarily::primarily
darabi::darabi
www.ijrws.org::www.ijrws.org
related::related
challenges::challenges
used::used
static::static
connect::connect
relates::relates
operation::operation
spies::spies
out::out
shown::shown
network::network
factors::factors
electronic::electronic
since::since
kallo::kallo
research::research
m2m::m2m
7::7
internet::internet
formula::formula
offline::offline
issue::issue
shows::shows
dataset::dataset
experiment::experiment
risen::risen
localization::localization
pre-recorded::pre-recorded
little::little
standard::standard
reason::reason
base::base
complicated::complicated
wi-fi::wi-fi
card::card
conform::conform
biju::biju
g::g
e.g::e.g
positioning::positioning
days::days
motion::motion
liaison::liaison
baala::baala
assumed::assumed
hence::hence
uses::uses
south::south
first::first
there::there
wlan::wlan
probability::probability
reveals::reveals
scene::scene
one::one
intuitively::intuitively
simplified::simplified
least::least
another::another
comprises::comprises
open::open
several::several
given::given
service::service
privacy::privacy
introduction::introduction
journals::journals
histograms::histograms
system::system
approximately::approximately
their::their
2::2
observations::observations
passed::passed
gps::gps
interests::interests
exploring::exploring
mostly::mostly
that::that
studies::studies
rejected::rejected
broadcast::broadcast
tracking::tracking
authors::authors
rizos::rizos
rss::rss
distance::distance
b::b
fuelled::fuelled
target::target
pursuing::pursuing
require::require
acknowledgement::acknowledgement
were::were
k::k
providing::providing
sungkuynkwan::sungkuynkwan
and::and
motivation::motivation
siddique::siddique
10-17::10-17
willingness::willingness
remained::remained
locations::locations
curves::curves
already::already
manner::manner
have::have
seen::seen
null::null
any::any
she::she
conversion::conversion
strength::strength
foot::foot
wlan-based::wlan-based
pursued::pursued
precalculated::precalculated
canalda::canalda
bekris::bekris
note::note
also::also
take::take
which::which
online::online
performance::performance
strengths::strengths
marceau::marceau
transparent::transparent
accuracy::accuracy
experienced::experienced
shall::shall
measures::measures
most::most
connected::connected
significant::significant
representation::representation
services::services
acknowledgements::acknowledgements
measured::measured
the::the
wireless::wireless
mobile::mobile
average::average
popularity::popularity
m::m
drive::drive
proceedings::proceedings
points::points
inaccuracies::inaccuracies
mechanical::mechanical
senior::senior
typically::typically
calculates::calculates
fact::fact
particularly::particularly
show::show
indoor::indoor
bring::bring
attempts::attempts
relation::relation
keywords::keywords
rough::rough
networks::networks
o::o
considered::considered
guidance::guidance
distributed::distributed
enough::enough
should::should
only::only
hasan*::hasan*
factor::factor
employed::employed
local::local
accurate::accurate
hall::hall
meant::meant
do::do
his::his
assistant::assistant
patnaik::patnaik
express::express
overall::overall
preferred::preferred
12::12
despite::despite
during::during
represented::represented
comply::comply
areas::areas
laptop::laptop
settings::settings
h::h
email::email
book::book
investigate::investigate
infrastructure-based::infrastructure-based
multi-point::multi-point
activity::activity
where::where
trilateriation::trilateriation
restaurants::restaurants
kernel::kernel
ned::ned
exists::exists
attenuated::attenuated
intelligence::intelligence
unisinos::unisinos
observed::observed
namely::namely
infrastructure::infrastructure
college::college
are::are
techniques::techniques
away::away
currently::currently
3::3
various::various
electrical::electrical
between::between
consecutive::consecutive
prevailing::prevailing
conditions::conditions
across::across
available::available
we::we
korea::korea
recently::recently
receivers::receivers
however::however
hypothesis::hypothesis
burnato::burnato
modeling::modeling
cities::cities
distribution::distribution
improve::improve
both::both
c::c
region::region
annual::annual
syed::syed
enabling::enabling
etc::etc
s::s
figures::figures
802.3::802.3
faces::faces
pdf::pdf
experimental::experimental
exhibit::exhibit
relevant::relevant
-67dbm::-67dbm
point::point
simple::simple
overview::overview
corresponds::corresponds
environments::environments
sampling::sampling
alone::alone
sao::sao
throughout::throughout
undergraduate::undergraduate
along::along
conference::conference
better::better
pp::pp
802.11::802.11
basis::basis
addition::addition
west::west
due::due
been::been
quickly::quickly
interest::interest
basic::basic
collected::collected
empty::empty
faraz::faraz
direction::direction
shopping::shopping
received::received
new::new
readings::readings
fund::fund
med-hoc-networks::med-hoc-networks
surveys::surveys
protocols::protocols
case::case
homes::homes
robotics-based::robotics-based
east::east
developing::developing
these::these
cybernetics::cybernetics
engineering::engineering
value::value
n::n
employ::employ
while::while
transactions::transactions
involved::involved
31::31
orientation::orientation
conferences::conferences
vol::vol
characteristics::characteristics
is::is
it::it
ii::ii
examined::examined
malls::malls
35::35
in::in
backhaul::backhaul
technology::technology
if::if
different::different
author::author
suggest::suggest
make::make
cumulative::cumulative
same::same
complex::complex
widely::widely
9::9
gets::gets
difficult::difficult
wires::wires
1-4::1-4
wps::wps
running::running
wired::wired
user::user
student::student
wi-fibased::wi-fibased
changing::changing
cypriani::cypriani
task::task
database::database
i::i
navigation::navigation
no::no
well::well
analysis::analysis
academic::academic
directly::directly
without::without
comes::comes
sets::sets
y::y
position::position
model::model
sensing::sensing
b.e::b.e
outdoor::outdoor
being::being
generally::generally
guided::guided
hybrid::hybrid
rest::rest
satellites::satellites
human::human
world::world
previous::previous
generous::generous
accepted::accepted
liu::liu
ease::ease
conclude::conclude
mathematically::mathematically
signals::signals
setting::setting
4::4
samples::samples
context-aware::context-aware
5::5
extensive::extensive
has::has
real::real
ladd::ladd
tests::tests
fluctuating::fluctuating
increased::increased
kavraki::kavraki
drawn::drawn
praxis::praxis
papers::papers
community::community
low-mobility::low-mobility
using::using
poses::poses
massively::massively
wirelessly::wirelessly
modifications::modifications
pertinent::pertinent
intel::intel
follows::follows
signal::signal
fingerprints::fingerprints
communications::communications
offices::offices
either::either
setups::setups
works::works
stationary::stationary
ijrws::ijrws
mathematical::mathematical
deviation::deviation
because::because
methods::methods
dempster::dempster
sungkyunkwan::sungkyunkwan
some::some
suspended::suspended
experiments::experiments
advertise::advertise
matching::matching
fingerprinting::fingerprinting
and/or::and/or
highlighting::highlighting
for::for
affects::affects
measurements::measurements
recorded::recorded
telecommunications::telecommunications
does::does
innovation::innovation
steps::steps
three::three
locate::locate
be::be
particular::particular
plot::plot
journal::journal
processing::processing
step::step
inherently::inherently
architectural::architectural
found::found
plots::plots
analyses::analyses
by::by
on::on
about::about
central::central
communicating::communicating
stations::stations
of::of
introduces::introduces
location::location
recognized::recognized
hasan::hasan
range::range
done::done
discusses::discusses
centrino::centrino
or::or
lasabe::lasabe
software::software
presence::presence
communication::communication
into::into
predictions::predictions
device::device
references::references
determine::determine
elementary::elementary
often::often
37::37
networking::networking
her::her
area::area
probabilistic::probabilistic
support::support
people::people
los::los
way::way
translate::translate
was::was
authored::authored
therefore::therefore
function::function
considerably::considerably
banerjee::banerjee
north::north
differences::differences
but::but
gaussian::gaussian
volume::volume
e::e
role::role
with::with
infers::infers
deployed::deployed
he::he
responding::responding
compute::compute
j::j
variations::variations
devices::devices
windows::windows
hand::hand
chipset::chipset
problem::problem
professor::professor
nature::nature
152::152
ad::ad
computing::computing
certain::certain
abstract::abstract
an::an
ap::ap
as::as
at::at
goodness::goodness
laboratory::laboratory
controlled::controlled
cables::cables
check::check
2002::2002
functions::functions
ideally::ideally
antenna::antenna
variety::variety
advanced-n::advanced-n
when::when
580-586::580-586
chakraborty::chakraborty
other::other
republic::republic
normal::normal
spatial::spatial
test::test
2006::2006
conclusion::conclusion
node::node
users::users
amaral::amaral
models::models
suwon::suwon
enrolled::enrolled
variation::variation
generated::generated
important::important
weekend::weekend
building::building
teixeira::teixeira
skku.edu::skku.edu
samsung::samsung
corresponding::corresponding
interval::interval
dr::dr
lans::lans
2007::2007
2005::2005
2008::2008
requires::requires
6230::6230
