::
limited::limited
similarity::similarity
desirable::desirable
four::four
entropy::entropy
consists::consists
t61p::t61p
localized::localized
whose::whose
flannery::flannery
220:671680::220:671680
fine-grained::fine-grained
under::under
@::@
collaborate::collaborate
varshavsky::varshavsky
dynamic::dynamic
distort::distort
every::every
affect::affect
node-to-node::node-to-node
wooden::wooden
solution::solution
correct::correct
vector::vector
indices::indices
enjoy::enjoy
10i::10i
10m::10m
phones::phones
consistent::consistent
estimates::estimates
likely::likely
estimated::estimated
machines::machines
even::even
co-circular::co-circular
+::+
selected::selected
supplied::supplied
above::above
new::new
off-theshelf::off-theshelf
cull::cull
deemed::deemed
simultaneously::simultaneously
behavior::behavior
never::never
here::here
jcai::jcai
reported::reported
granularity::granularity
active::active
path::path
100::100
101::101
obtained::obtained
ladars::ladars
ventures::ventures
elaborate::elaborate
reports::reports
anchor::anchor
suitable::suitable
raphson::raphson
visible::visible
specifics::specifics
gps-free::gps-free
total::total
linearly::linearly
experimentation::experimentation
would::would
found::found
multi-tenant::multi-tenant
achieve::achieve
m1::m1
m2::m2
type::type
until::until
laptop-ipaq::laptop-ipaq
brings::brings
naive::naive
phone::phone
p2j2::p2j2
excellent::excellent
90::90
ward::ward
must::must
1991::1991
1992::1992
1997::1997
1998::1998
work::work
wlans::wlans
root::root
example::example
locselect::locselect
indicated::indicated
give::give
programming::programming
preserving::preserving
india::india
indicates::indicates
want::want
absolute::absolute
end::end
provide::provide
multi-path::multi-path
machine::machine
transitively::transitively
methodology::methodology
hou::hou
answer::answer
description::description
after::after
hence::hence
2.8m::2.8m
minimizes::minimizes
parallel::parallel
sextant::sextant
effective::effective
maintain::maintain
algorithms::algorithms
order::order
operations::operations
office::office
over::over
vary::vary
satisfied::satisfied
6.2::6.2
6.1::6.1
6.0::6.0
bounding::bounding
non-convex::non-convex
before::before
mea1::mea1
constandache::constandache
entrances::entrances
pkij::pkij
personal::personal
highlights::highlights
fix::fix
better::better
fig::fig
overcome::overcome
versus::versus
then::then
them::them
combination::combination
amenable::amenable
otsason::otsason
kung::kung
effects::effects
they::they
represents::represents
alex::alex
vinod::vinod
reasonably::reasonably
l::l
each::each
interpolation::interpolation
pki1::pki1
pki2::pki2
mean::mean
schemes::schemes
nave::nave
independent::independent
series::series
comprises::comprises
attenuation::attenuation
gradient::gradient
restricted::restricted
crucial::crucial
rf::rf
reader::reader
surprise::surprise
newly::newly
forth::forth
ri::ri
numerical::numerical
linear::linear
surveys::surveys
free::free
standard::standard
sensors::sensors
r4::r4
r5::r5
r6::r6
r1::r1
r2::r2
r3::r3
starts::starts
days::days
youssef::youssef
signature::signature
purpose::purpose
::
features::features
rank::rank
channels::channels
floors::floors
another::another
178::178
177::177
176::176
175::175
174::174
173::173
top::top
approximately::approximately
needed::needed
perturbations::perturbations
observations::observations
eqn::eqn
padhye::padhye
john::john
centered::centered
took::took
somewhat::somewhat
maintaining::maintaining
guha::guha
begins::begins
distance::distance
lenovo::lenovo
communicate::communicate
target::target
showed::showed
iros::iros
enabled::enabled
second::second
collinear::collinear
kth::kth
powers::powers
fashion::fashion
sees::sees
entail::entail
ran::ran
navigate::navigate
outperforms::outperforms
manner::manner
seen::seen
relatively::relatively
strength::strength
responsible::responsible
savings::savings
vice-versa::vice-versa
doors::doors
transmit::transmit
coarse-grained::coarse-grained
circles::circles
acquire::acquire
transactions::transactions
deploys::deploys
accurately::accurately
metrics::metrics
extending::extending
errors::errors
phase::phase
p1n,1m::p1n,1m
assisting::assisting
treats::treats
partition::partition
m::m
inferred::inferred
points::points
principle::principle
enterprise::enterprise
notion::notion
dot::dot
dover::dover
signatures::signatures
differed::differed
random::random
infrared::infrared
7.2::7.2
attempts::attempts
7.1::7.1
radio::radio
solutions::solutions
participate::participate
i780::i780
layout::layout
proposed::proposed
implementation::implementation
situations::situations
do::do
mixture::mixture
localizing::localizing
calibration-free::calibration-free
db::db
yielded::yielded
ssids::ssids
despite::despite
report::report
onboard::onboard
14::14
bat::bat
increasing::increasing
traverses::traverses
architecture::architecture
percentile::percentile
analytical::analytical
implication::implication
::
fair::fair
testing::testing
mobihoc::mobihoc
observed::observed
depends::depends
radius::radius
result::result
fail::fail
best::best
techniques::techniques
exponent::exponent
8.11::8.11
8.10::8.10
r::r
conceptual::conceptual
drawn::drawn
previous::previous
approach::approach
we::we
terms::terms
extend::extend
nature::nature
vjk11::vjk11
however::however
location-support::location-support
qkj11::qkj11
picking::picking
improve::improve
suggested::suggested
received::received
essentially::essentially
ile::ile
uncertainty::uncertainty
against::against
participating::participating
floorplans::floorplans
receiver::receiver
requests::requests
simultanoues::simultanoues
gain-independent::gain-independent
represented::represented
three::three
been::been
hotnets::hotnets
impeding::impeding
interest::interest
basic::basic
expected::expected
pk2j11::pk2j11
efficacy::efficacy
25m::25m
pre-filtering::pre-filtering
agrawal::agrawal
160::160
srivastava::srivastava
n::n
employ::employ
near::near
suppose::suppose
sli::sli
stopping::stopping
aid::aid
8-core::8-core
property::property
k::k
procedure::procedure
is::is
ir::ir
tions::tions
it::it
ii::ii
ij::ij
exterior::exterior
in::in
qj2::qj2
if::if
containing::containing
descent::descent
perform::perform
recursion::recursion
make::make
cumulative::cumulative
expect::expect
potentially::potentially
avoids::avoids
several::several
grows::grows
perimeter::perimeter
evolve::evolve
nordin::nordin
horus::horus
i1::i1
i2::i2
hand::hand
hw6965::hw6965
opportunity::opportunity
provisioned::provisioned
off-the-shelf::off-the-shelf
scenario::scenario
epl::epl
client::client
mathews::mathews
simulated::simulated
the::the
non-trivial::non-trivial
unified::unified
protocol::protocol
::
just::just
laptop::laptop
newton::newton
rotated::rotated
assigned::assigned
clustered::clustered
identify::identify
|m::|m
|j::|j
yet::yet
|i::|i
adding::adding
depicts::depicts
han::han
ease::ease
had::had
5m::5m
spread::spread
easy::easy
has::has
hightower::hightower
possible::possible
ldpl::ldpl
unique::unique
massively::massively
58::58
performing::performing
manual::manual
50::50
53::53
specific::specific
steps::steps
experimentally::experimentally
right::right
old::old
people::people
meters::meters
multiple::multiple
fingerprinting::fingerprinting
dense::dense
for::for
communications::communications
fox::fox
/::/
unit::unit
participation::participation
constructive::constructive
181::181
post::post
properties::properties
bahl::bahl
ranges::ranges
o::o
magazine::magazine
ensure::ensure
efforts::efforts
slightly::slightly
automatically::automatically
functions::functions
contains::contains
publishing::publishing
presence::presence
obtaining::obtaining
balances::balances
down::down
locaij::locaij
refined::refined
reducing::reducing
methods::methods
rely::rely
support::support
initial::initial
approximate::approximate
accordingly::accordingly
way::way
resulted::resulted
call::call
gik::gik
gij::gij
head::head
2-7db::2-7db
form::form
differences::differences
wireless::wireless
true::true
subtracted::subtracted
builds::builds
cocircular::cocircular
radio-frequency::radio-frequency
maximum::maximum
devices::devices
::
computing::computing
abstract::abstract
''::''
inter-cluster::inter-cluster
exist::exist
triangles::triangles
constructed::constructed
ni::ni
tix::tix
dotted::dotted
floor::floor
whereas::whereas
when::when
reality::reality
chakraborty::chakraborty
setting::setting
digital::digital
test::test
node::node
refining::refining
models::models
constructs::constructs
uniformly::uniformly
miscellaneous::miscellaneous
scale::scale
gps-less::gps-less
variable::variable
jones::jones
faster::faster
assume::assume
interval::interval
pseudo::pseudo
together::together
time::time
push::push
wifi-enabled::wifi-enabled
reviewers::reviewers
real-time::real-time
alternatives::alternatives
focus::focus
roy::roy
anand::anand
computation::computation
7000::7000
depend::depend
graph::graph
technique::technique
hamdi::hamdi
environment::environment
0::0
finally::finally
compensate::compensate
di1::di1
di2::di2
smartphone::smartphone
advantage::advantage
wifi-based::wifi-based
choice::choice
anonymous::anonymous
14421447::14421447
partitions::partitions
dij::dij
level::level
did::did
p::p
maxrssapselect::maxrssapselect
mn::mn
illustrating::illustrating
occurrence::occurrence
hindered::hindered
cost::cost
yang::yang
current::current
model-based::model-based
badge::badge
wifi-slam::wifi-slam
satisfy::satisfy
-100::-100
inbuilding::inbuilding
v::v
address::address
along::along
anchoring::anchoring
appears::appears
change::change
savvides::savvides
box::box
incoming::incoming
infrequently::infrequently
studied::studied
heidemann::heidemann
simultaneous::simultaneous
navigation::navigation
tasks::tasks
useful::useful
::
flexibility::flexibility
additive::additive
working::working
scenarios::scenarios
selects::selects
entrance::entrance
diurnal::diurnal
towers::towers
sparsely::sparsely
rigid::rigid
considerable::considerable
cases::cases
effort::effort
insights::insights
apselect::apselect
10,000::10,000
rudys::rudys
modified::modified
longitude::longitude
labeled::labeled
values::values
can::can
following::following
making::making
figure::figure
predict::predict
arise::arise
0.7m::0.7m
locks::locks
incremental::incremental
performed::performed
allowed::allowed
spa::spa
s2::s2
discussion::discussion
rgea::rgea
trilateration::trilateration
1::1
criterion::criterion
scenario-ii::scenario-ii
optimal::optimal
parameter::parameter
map::map
product::product
landmark::landmark
aoa::aoa
5.1::5.1
may::may
max::max
needs::needs
applications::applications
mac::mac
designed::designed
such::such
data::data
goal::goal
classroom::classroom
whenever::whenever
explicit::explicit
yielding::yielding
annealing::annealing
so::so
progressively::progressively
jain::jain
typical::typical
enhancements::enhancements
indeed::indeed
course::course
experiments::experiments
still::still
ieee::ieee
solitary::solitary
group::group
thank::thank
how::how
interesting::interesting
wallach::wallach
vicinity::vicinity
coordinates::coordinates
window::window
decreased::decreased
decades::decades
thereby::thereby
matches::matches
introduce::introduce
records::records
not::not
nor::nor
matched::matched
r2-r6::r2-r6
mobiwac::mobiwac
january::january
possibilities::possibilities
en::en
significantly::significantly
::
populated::populated
gaussian::gaussian
challenges::challenges
gaps::gaps
c++::c++
ez::ez
et::et
avoided::avoided
n-hop::n-hop
shown::shown
space::space
profit::profit
vj2::vj2
vj1::vj1
squared::squared
increase::increase
viable::viable
shows::shows
inevitably::inevitably
theory::theory
mechanisms::mechanisms
quite::quite
krishnan::krishnan
besides::besides
advance::advance
training::training
kaufmann::kaufmann
choudhury::choudhury
iterative::iterative
turn::turn
gtsc::gtsc
first::first
xj::xj
intuition::intuition
adv7510::adv7510
wlan::wlan
variables::variables
one::one
long::long
directly::directly
carry::carry
impossible::impossible
open::open
size::size
given::given
mobicom::mobicom
yiu::yiu
indicate::indicate
2::2
realization::realization
pkmj::pkmj
speaking::speaking
fraction::fraction
that::that
kirkpatrick::kirkpatrick
eliminates::eliminates
odometers::odometers
1::1
attempt::attempt
eliminated::eliminated
copy::copy
than::than
ravindranath::ravindranath
11::11
10::10
13::13
12::12
15::15
unfortunately::unfortunately
17::17
16::16
19::19
18::18
require::require
showcase::showcase
future::future
were::were
dv-dist::dv-dist
inferring::inferring
and::and
zill::zill
locations::locations
crossover::crossover
say::say
slam::slam
distorted::distorted
any::any
computationally::computationally
describe::describe
infocom::infocom
note::note
potential::potential
take::take
objective::objective
performance::performance
adjusting::adjusting
padmanab::padmanab
sure::sure
pain::pain
normal::normal
paid::paid
falls::falls
successive::successive
pair::pair
pages::pages
localizable::localizable
gk1::gk1
average::average
later::later
managing::managing
mobisys::mobisys
vjk22::vjk22
typically::typically
discovered::discovered
spaces::spaces
threshold::threshold
raju::raju
ground::ground
ultra-sound::ultra-sound
enough::enough
deployments::deployments
only::only
explicitly::explicitly
implemented::implemented
equipped::equipped
boundary::boundary
krishna::krishna
resource::resource
settings::settings
ad-hoc::ad-hoc
versions::versions
median::median
borrow::borrow
yield::yield
checks::checks
paper::paper
where::where
reveals::reveals
attenuated::attenuated
severely::severely
j1::j1
j2::j2
relative::relative
elected::elected
namely::namely
actively::actively
0,20::0,20
held::held
label::label
boundaries::boundaries
3::3
between::between
geometric::geometric
reading::reading
across::across
arrival::arrival
notice::notice
infrastructure::infrastructure
jy::jy
parent::parent
receivers::receivers
refine::refine
ju::ju
analyzes::analyzes
comm::comm
ji::ji
analyzed::analyzed
come::come
fit::fit
many::many
region::region
flipped::flipped
enabling::enabling
propagation::propagation
s::s
comes::comes
among::among
filtering::filtering
color::color
overview::overview
robotics::robotics
sampling::sampling
60::60
61::61
65::65
156::156
netbooks::netbooks
snew::snew
technical::technical
adv7501::adv7501
enable::enable
formed::formed
pjk::pjk
readings::readings
centerpiece::centerpiece
bayesian::bayesian
careful::careful
32::32
case::case
these::these
accommodating::accommodating
vecchi::vecchi
promising::promising
situation::situation
eventually::eventually
characteristics::characteristics
metric::metric
cluster::cluster
ambient::ambient
return::return
biaz::biaz
wisely::wisely
comments::comments
different::different
d11::d11
d12::d12
granted::granted
same::same
physical::physical
assigns::assigns
closest::closest
rfid::rfid
running::running
edges::edges
c.2::c.2
azizyan::azizyan
relies::relies
tracking::tracking
j1th::j1th
minimize::minimize
no::no
roughly::roughly
lawrence::lawrence
without::without
solve::solve
alleviate::alleviate
relied::relied
coordinate::coordinate
model::model
outdoor::outdoor
minima::minima
being::being
captures::captures
rest::rest
banzhaf::banzhaf
crowd-sourcing::crowd-sourcing
unclear::unclear
surroundsense::surroundsense
incurring::incurring
-20dbm::-20dbm
2.1m::2.1m
except::except
desktop::desktop
4::4
extensive::extensive
real::real
ladd::ladd
around::around
early::early
grid::grid
xenovo::xenovo
world::world
execution::execution
reduces::reduces
server::server
microsoft.com::microsoft.com
benefit::benefit
gjk::gjk
assists::assists
priyantha::priyantha
reduced::reduced
simulator::simulator
p1j2::p1j2
exposes::exposes
respect::respect
pk1j11::pk1j11
matching::matching
provided::provided
dimensions::dimensions
freer::freer
stops::stops
dv-hop::dv-hop
provides::provides
ray-tracing::ray-tracing
power::power
seconds::seconds
fitness::fitness
notable::notable
mayers::mayers
notably::notably
padmanabhan::padmanabhan
2m::2m
on::on
conducting::conducting
central::central
of::of
discussed::discussed
acm::acm
side::side
practical::practical
8.9::8.9
stand::stand
act::act
lasting::lasting
or::or
cambridge::cambridge
beacons::beacons
communication::communication
references::references
determine::determine
theoretically::theoretically
log::log
area::area
assumed::assumed
unmodified::unmodified
there::there
start::start
low::low
assumes::assumes
sophisticated::sophisticated
agrawala::agrawala
unreliable::unreliable
with::with
pull::pull
outliers::outliers
gwon::gwon
|o|::|o|
embed::embed
connect::connect
detailed::detailed
scanner::scanner
certain::certain
citation::citation
moved::moved
al::al
an::an
ap::ap
as::as
at::at
diversity::diversity
again::again
4.1::4.1
ideally::ideally
4.2::4.2
hybrid::hybrid
2000::2000
narrowing::narrowing
2001::2001
5::5
stumbles::stumbles
v-anandi::v-anandi
spatial::spatial
2007::2007
deviation::deviation
briefly::briefly
configuration-free::configuration-free
collaborative::collaborative
separate::separate
important::important
coverage::coverage
tackle::tackle
building::building
laptops::laptops
d21::d21
d22::d22
curve::curve
parallelism::parallelism
cores::cores
original::original
all::all
since::since
lakshmanan::lakshmanan
lack::lack
krishnakumar::krishnakumar
80th::80th
follow::follow
pre-deployment::pre-deployment
batches::batches
to::to
preserved::preserved
th::th
stochastic::stochastic
nodes::nodes
sound::sound
worse::worse
very::very
mpi::mpi
smartphones::smartphones
worst::worst
msr-tr-2000-12::msr-tr-2000-12
fall::fall
difference::difference
condition::condition
treating::treating
unlike::unlike
issue::issue
list::list
large::large
small::small
ten::ten
5.2::5.2
past::past
rate::rate
design::design
further::further
choices::choices
returned::returned
11db::11db
what::what
nonlinear::nonlinear
advantageous::advantageous
niculescu::niculescu
gk::gk
section::section
localization::localization
brief::brief
version::version
issues::issues
method::method
contrast::contrast
full::full
component::component
hours::hours
3.1m::3.1m
i.e::i.e
equations::equations
search::search
houses::houses
allows::allows
experience::experience
prior::prior
amount::amount
pick::pick
narrow::narrow
uniquely::uniquely
via::via
followed::followed
requiring::requiring
mobicom10::mobicom10
trained::trained
establish::establish
estimate::estimate
select::select
readily::readily
earliest::earliest
takes::takes
otsasonet::otsasonet
ldone::ldone
coupled::coupled
two::two
odometer::odometer
comparing::comparing
6::6
taken::taken
more::more
descriptors::descriptors
sniffers::sniffers
leonard::leonard
tested::tested
particular::particular
known::known
retained::retained
none::none
client-server::client-server
science::science
equation::equation
created::created
mall::mall
nine::nine
morgan::morgan
learn::learn
strategies::strategies
specialized::specialized
compare::compare
challenging::challenging
scan::scan
snoeren::snoeren
minimum::minimum
sense::sense
!::!
information::information
respective::respective
recursive::recursive
rather::rather
maps::maps
occasionally::occasionally
murty::murty
sirer::sirer
either::either
simplicity::simplicity
plans::plans
derived::derived
mapping::mapping
connectivity::connectivity
krchinta::krchinta
1.5,6.0::1.5,6.0
evaluations::evaluations
a::a
-51::-51
crowded::crowded
patil::patil
help::help
ith::ith
september::september
developed::developed
installed::installed
radar::radar
already::already
through::through
existence::existence
its::its
24::24
25::25
26::26
27::27
20::20
21::21
22::22
23::23
solving::solving
28::28
29::29
actually::actually
absence::absence
systems::systems
initializing::initializing
might::might
good::good
motivated::motivated
was::was
propose::propose
reflected::reflected
framework::framework
walls::walls
easily::easily
solves::solves
cubicles::cubicles
solver::solver
refresh::refresh
2d::2d
iff::iff
inherent::inherent
2n::2n
residing::residing
referred::referred
constructing::constructing
179::179
weight::weight
generation::generation
hundred::hundred
energy::energy
hard::hard
reduce::reduce
idea::idea
deterministically::deterministically
obtains::obtains
measurement::measurement
operation::operation
beyond::beyond
event::event
solved::solved
surrounded::surrounded
research::research
7::7
offline::offline
evaluation::evaluation
offsets::offsets
difficulty::difficulty
reason::reason
base::base
included::included
ask::ask
padmanabha::padmanabha
generate::generate
pairs::pairs
benefits::benefits
thread::thread
e.g::e.g
airport::airport
positioning::positioning
introduction::introduction
conducted::conducted
exponentially::exponentially
w::w
widely-used::widely-used
probability::probability
thereafter::thereafter
number::number
utilized::utilized
unexpected::unexpected
construct::construct
3db::3db
htc::htc
miss::miss
guess::guess
perturbation::perturbation
leverage::leverage
jez::jez
least::least
182::182
183::183
180::180
assumption::assumption
184::184
surements::surements
scheme::scheme
exponents::exponents
gps::gps
behind::behind
part::part
translation::translation
believe::believe
center::center
i-a::i-a
albeit::albeit
i-b::i-b
intermittent::intermittent
2024::2024
nevertheless::nevertheless
determined::determined
contrary::contrary
outdoors::outdoors
modeled::modeled
7m::7m
randomly::randomly
substantial::substantial
cognizant::cognizant
lie::lie
built::built
zero::zero
depending::depending
lim::lim
k2::k2
k1::k1
square::square
build::build
jacobian::jacobian
ez+loc::ez+loc
proline::proline
measures::measures
most::most
plan::plan
significant::significant
position::position
measured::measured
mobile::mobile
clear::clear
sometimes::sometimes
cover::cover
clean::clean
hindrance::hindrance
physics::physics
microsoft::microsoft
cdf::cdf
1.8m::1.8m
pre-wifi::pre-wifi
capkun::capkun
degrades::degrades
carefully::carefully
degraded::degraded
find::find
henceforth::henceforth
-49::-49
parameters::parameters
-43::-43
-41::-41
distributed::distributed
transmitting::transmitting
factor::factor
8::8
circle::circle
merged::merged
shepherd::shepherd
his::his
gains::gains
permission::permission
line-of-sight::line-of-sight
b::b
listed::listed
combinations::combinations
during::during
3a::3a
investigate::investigate
common::common
x::x
scanning::scanning
cdone::cdone
set::set
lamarca::lamarca
achieved::achieved
see::see
proliferation::proliferation
are::are
opportunistically::opportunistically
close::close
deploying::deploying
chose::chose
#::#
learns::learns
glass/metal::glass/metal
various::various
consecutive::consecutive
conditions::conditions
gathered::gathered
knowing::knowing
profiling::profiling
recently::recently
hardship::hardship
initially::initially
sold::sold
acknowledgements::acknowledgements
ranked::ranked
interface::interface
both::both
c::c
paradigms::paradigms
improved::improved
improves::improves
context::context
finds::finds
experimental::experimental
reside::reside
consume::consume
0,1::0,1
large-scale::large-scale
simple::simple
hollow::hollow
simply::simply
consideration::consideration
throughout::throughout
described::described
sghi780::sghi780
create::create
3.3m::3.3m
due::due
strategy::strategy
ensured::ensured
ekahau::ekahau
collected::collected
extends::extends
pi::pi
empty::empty
pkij22::pkij22
gas::gas
else::else
determination::determination
representative::representative
assigning::assigning
p2::p2
p1::p1
exponential::exponential
solid::solid
batch::batch
evaluated::evaluated
receive::receive
while::while
optimization::optimization
evaluating::evaluating
error::error
vectors::vectors
averaging::averaging
itself::itself
x61::x61
belong::belong
wherein::wherein
widely::widely
9::9
higher::higher
used::used
comprehensive::comprehensive
levels::levels
uses::uses
user::user
robust::robust
task::task
database::database
studies::studies
analysis::analysis
picks::picks
landmarc::landmarc
concrete::concrete
edge::edge
y::y
gsm::gsm
distances::distances
6.1.2::6.1.2
6.1.1::6.1.1
deployment::deployment
questions::questions
using::using
alternative::alternative
j2th::j2th
e::e
cut::cut
$::$
also::also
alternate::alternate
pillars::pillars
location::location
solvable::solvable
remaining::remaining
luxury::luxury
evaluate::evaluate
madigan::madigan
formal::formal
12m::12m
modifications::modifications
rotate::rotate
d::d
-37::-37
follows::follows
signal::signal
-31::-31
separately::separately
collect::collect
yields::yields
translated::translated
essential::essential
gelatt::gelatt
often::often
creation::creation
some::some
strongest::strongest
3.2::3.2
examples::examples
ipaq-ipaq::ipaq-ipaq
3.1::3.1
curious::curious
discarded::discarded
and/or::and/or
measurements::measurements
room-level::room-level
per::per
lara::lara
best-performing::best-performing
minimal::minimal
t::t
be::be
-50dbm::-50dbm
run::run
fed::fed
step::step
haeberlen::haeberlen
feb::feb
subtract::subtract
by::by
avgrssapselect::avgrssapselect
noncollinear::noncollinear
constraint::constraint
range::range
extensions::extensions
consequently::consequently
computational::computational
into::into
within::within
servers::servers
perturbing::perturbing
ellipse::ellipse
clustering::clustering
navigon::navigon
span::span
extremely::extremely
placing::placing
question::question
specifically::specifically
custom::custom
analyze::analyze
sections::sections
relaxed::relaxed
hopes::hopes
line::line
ezs::ezs
exhaustive::exhaustive
deployed::deployed
observation::observation
coarser::coarser
transmits::transmits
us::us
1.5m::1.5m
windows::windows
those::those
autonomous::autonomous
z::z
similar::similar
globecom::globecom
constant::constant
likewise::likewise
specified::specified
``::``
globally::globally
single::single
steeper::steeper
%::%
fixing::fixing
occasional::occasional
started::started
log-distance::log-distance
priori::priori
elements::elements
users::users
over-determined::over-determined
helping::helping
generated::generated
allowing::allowing
1-3db::1-3db
ariadne::ariadne
structure::structure
independently::independently
implies::implies
algorithm::algorithm
required::required
walked::walked
2003::2003
ascertained::ascertained
train::train
2006::2006
came::came
2004::2004
2005::2005
far::far
2009::2009
requires::requires
having::having
proximate::proximate
once::once
code::code
results::results
existing::existing
gd::gd
ga::ga
query::query
contributions::contributions
gj::gj
gi::gi
deterministic::deterministic
intensive::intensive
helps::helps
ambience::ambience
include::include
dramatically::dramatically
indicating::indicating
hicss::hicss
outside::outside
hopper::hopper
continues::continues
cellular::cellular
mixing::mixing
categories::categories
entire::entire
redistribute::redistribute
transmission::transmission
positions::positions
?::?
noted::noted
smaller::smaller
compensated::compensated
filled::filled
picked::picked
chicago::chicago
networks::networks
access::access
experiment::experiment
3m::3m
3b::3b
;::;
exercise::exercise
body::body
non-linear::non-linear
ersga::ersga
degree::degree
50th::50th
respectively::respectively
leveraging::leveraging
commercial::commercial
separation::separation
latent::latent
imperfections::imperfections
convert::convert
38::38
copyright::copyright
floorplan::floorplan
33::33
involved::involved
31::31
30::30
37::37
36::36
35::35
34::34
suggests::suggests
products::products
7:2834::7:2834
makes::makes
involves::involves
sirf::sirf
addresses::addresses
aps::aps
scaled::scaled
sgh::sgh
decrease::decrease
wolman::wolman
cloud::cloud
use::use
fee::fee
from::from
usa::usa
remains::remains
few::few
depicted::depicted
examination::examination
themselves::themselves
ap2::ap2
becomes::becomes
ap1::ap1
ap6::ap6
carrying::carrying
normalized::normalized
chintalapudi::chintalapudi
iii::iii
moses::moses
balakrishnan::balakrishnan
account::account
f::f
this::this
challenge::challenge
clients::clients
unknowns::unknowns
obvious::obvious
proof::proof
0.8::0.8
process::process
lock::lock
0.2::0.2
0.4::0.4
0.6::0.6
high::high
effectively::effectively
assumptions::assumptions
keller::keller
employs::employs
10.00::10.00
sit::sit
located::located
instead::instead
fare::fare
buildings::buildings
collection::collection
fits::fits
efficiently::efficiently
light::light
lines::lines
robot::robot
avriel::avriel
element::element
allow::allow
3.1.2::3.1.2
3.1.1::3.1.1
poor::poor
move::move
meter::meter
parallelized::parallelized
including::including
pandey::pandey
converting::converting
decay::decay
chosen::chosen
temporal::temporal
li::li
estimating::estimating
inspecting::inspecting
latitude::latitude
clusters::clusters
2010::2010
13b::13b
13a::13a
greater::greater
python::python
lan-based::lan-based
practice::practice
runs::runs
santhanam::santhanam
fingerprint::fingerprint
rotation::rotation
day::day
republish::republish
university::university
identified::identified
k-nearest::k-nearest
truth::truth
|::|
constraints::constraints
subset::subset
inputs::inputs
related::related
constitute::constitute
static::static
variety::variety
measure::measure
our::our
80::80
special::special
out::out
obstructions::obstructions
asymmetries::asymmetries
performs::performs
ladar::ladar
winet::winet
greedy::greedy
approaches::approaches
likelihood::likelihood
1983::1983
g::g
determining::determining
could::could
times::times
linearizes::linearizes
south::south
transmitters::transmitters
third::third
::
traverse::traverse
4.4m::4.4m
dividing::dividing
sockets::sockets
pmj2::pmj2
reference::reference
ferris::ferris
unknown::unknown
system::system
priority::priority
their::their
non-collinear::non-collinear
scans::scans
pervasive::pervasive
//www.ekahau.com/:://www.ekahau.com/
exactly::exactly
lists::lists
larger::larger
durrant-whyte::durrant-whyte
rss::rss
compensation::compensation
individual::individual
ipaq::ipaq
providing::providing
collecting::collecting
1.5::1.5
false::false
unchanged::unchanged
curves::curves
unavailability::unavailability
have::have
laptopipaq::laptopipaq
need::need
constrained::constrained
clearly::clearly
depict::depict
angle::angle
able::able
mechanism::mechanism
instance::instance
which::which
multilateration::multilateration
singh::singh
subject::subject
=::=
accuracy::accuracy
unless::unless
who::who
connected::connected
device::device
class::class
placement::placement
1.3m::1.3m
neighboring::neighboring
construction::construction
databases::databases
fact::fact
selection::selection
dbm::dbm
answered::answered
indoor::indoor
venkata::venkata
subtracting::subtracting
based::based
knowledge::knowledge
much::much
should::should
jan::jan
entities::entities
local::local
hope::hope
x.-y::x.-y
cube::cube
means::means
overall::overall
bear::bear
ones::ones
words::words
liu::liu
h::h
comprising::comprising
pkij11::pkij11
processed::processed
rf-based::rf-based
queries::queries
fixed::fixed
generations::generations
view::view
available::available
requirement::requirement
hubaux::hubaux
modulo::modulo
computed::computed
exists::exists
ipaqipaq::ipaqipaq
configured::configured
computes::computes
computer-communication::computer-communication
operated::operated
creating::creating
closer::closer
7db::7db
exploited::exploited
:4247:::4247
state::state
closed::closed
invariant::invariant
neither::neither
interfaces::interfaces
luo::luo
ability::ability
constituted::constituted
importance::importance
efficiency::efficiency
key::key
chipset::chipset
calibrationintensive::calibrationintensive
configuration::configuration
problem::problem
equal::equal
etc::etc
figures::figures
passing::passing
estimation::estimation
otherwise::otherwise
ci::ci
relevant::relevant
l-shaped::l-shaped
environments::environments
walk::walk
table::table
8.1::8.1
8.3::8.3
8.2::8.2
8.5::8.5
8.4::8.4
8.7::8.7
8.6::8.6
addition::addition
8.8::8.8
copies::copies
responds::responds
immense::immense
genetic::genetic
compensating::compensating
kitchen::kitchen
>::>
arises::arises
corresponding::corresponding
sufficient::sufficient
ensuring::ensuring
c3::c3
c2::c2
c1::c1
general::general
present::present
novel::novel
subsets::subsets
balachandran::balachandran
value::value
<::<
will::will
cell::cell
manually::manually
almost::almost
thus::thus
ipaq-1::ipaq-1
weighed::weighed
malls::malls
dkij::dkij
capture::capture
landmarks::landmarks
r1-r6::r1-r6
difficult::difficult
experimented::experimented
http::http
upon::upon
effect::effect
vironment::vironment
reflection::reflection
bootstrapping::bootstrapping
i::i
obstacles::obstacles
well::well
sheer::sheer
sets::sets
comparisons::comparisons
sensing::sensing
|pik::|pik
less::less
proximity::proximity
obtain::obtain
tcp::tcp
underlying::underlying
localize::localize
dair::dair
generous::generous
localizability::localizability
qkj22::qkj22
capabilities::capabilities
battery::battery
nath::nath
combine::combine
attractive::attractive
match::match
estrin::estrin
kavraki::kavraki
devised::devised
five::five
know::know
burden::burden
denser::denser
press::press
loss::loss
necessary::necessary
sizes::sizes
alternatively::alternatively
martin::martin
become::become
works::works
page::page
exhaustively::exhaustively
because::because
belonged::belonged
searching::searching
ventilated::ventilated
convex::convex
star::star
iyer::iyer
lead::lead
demonstrates::demonstrates
avoid::avoid
overlap::overlap
does::does
mutation::mutation
assuming::assuming
mined::mined
leverages::leverages
demonstrated::demonstrated
locate::locate
pnormalized::pnormalized
selecting::selecting
uated::uated
non-localizability::non-localizability
although::although
offset::offset
802.11::802.11
periodically::periodically
simpler::simpler
about::about
978-1-4503-0181-7/10/09::978-1-4503-0181-7/10/09
actual::actual
carried::carried
freedom::freedom
dependence::dependence
dependency::dependency
francone::francone
insufficient::insufficient
transitive::transitive
software::software
own::own
ultrasound::ultrasound
weighted::weighted
additional::additional
housing::housing
noticed::noticed
quadratic::quadratic
terminates::terminates
function::function
cricket::cricket
north::north
hp::hp
but::but
repeated::repeated
hierarchical::hierarchical
gain::gain
automated::automated
highest::highest
made::made
compute::compute
places::places
whether::whether
j::j
variations::variations
flip::flip
record::record
below::below
converted::converted
limit::limit
aprandominit::aprandominit
demonstrate::demonstrate
distribution::distribution
piece::piece
minutes::minutes
pij::pij
wifi::wifi
co-located::co-located
t61::t61
mobile-to-mobile::mobile-to-mobile
nicelescu::nicelescu
effected::effected
mutual::mutual
compared::compared
48::48
calibration::calibration
trials::trials
detail::detail
40::40
illinois::illinois
other::other
conclusion::conclusion
eval1::eval1
repeat::repeat
kinds::kinds
100m::100m
inherently::inherently
pi0::pi0
pi1::pi1
pi2::pi2
deter::deter
pre-measured::pre-measured
searches::searches
coupling::coupling
samsung::samsung
factors::factors
rule::rule
coincidentally::coincidentally
4m::4m
searched::searched
understand::understand
furthermore::furthermore
trilaterate::trilaterate
