::
code::code
dynamic::dynamic
switches::switches
ge::ge
13.56::13.56
computation::computation
tx::tx
environment::environment
to::to
externalselect-des+na+on::externalselect-des+na+on
include::include
@::@
very::very
frequencies::frequencies
undergraduate/graduate::undergraduate/graduate
wave::wave
entire::entire
cmd::cmd
wsn::wsn
-5::-5
-4::-4
-7::-7
-6::-6
-3::-3
-2::-2
-genera+on-and-demodula+onelectro::-genera+on-and-demodula+onelectro
-9::-9
-8::-8
direct::direct
rate::rate
correlator::correlator
akbar::akbar
analogsensor::analogsensor
complexities::complexities
section::section
-20::-20
-21::-21
-22::-22
-23::-23
access::access
daughtercard-port::daughtercard-port
tags::tags
understanding::understanding
modular::modular
labs::labs
900::900
rfid-enabled::rfid-enabled
30::30
allows::allows
manchester-encoded::manchester-encoded
chemical::chemical
usually::usually
433::433
via::via
digitally::digitally
private::private
flexibility::flexibility
byte::byte
intensive::intensive
from::from
usa::usa
&::&
readability::readability
op+cal-systems-laboratory-|-eosl::op+cal-systems-laboratory-|-eosl
microcontrollerti::microcontrollerti
antennas::antennas
hardware::hardware
f::f
work::work
timingrecoveryconstella+onreceiverunpack-kbitselectro::timingrecoveryconstella+onreceiverunpack-kbitselectro
freedom::freedom
bashir::bashir
dedicated::dedicated
figure::figure
states::states
tag::tag
!::!
information::information
educational::educational
end::end
5.8::5.8
arrangement::arrangement
1::1
modulations::modulations
blocks::blocks
modulation::modulation
southern::southern
accel_data::accel_data
diagram::diagram
applications::applications
querysensorsinsert-tag-id::querysensorsinsert-tag-id
designed::designed
data::data
waredenedradio::waredenedradio
power-optimized::power-optimized
ghz::ghz
or::or
complexity::complexity
so::so
allow::allow
-headercalculatecrcmanchesterencodebackscazerelectro::-headercalculatecrcmanchesterencodebackscazerelectro
bpsk::bpsk
september::september
radar::radar
experiments::experiments
4::4
135::135
25::25
platform::platform
systems::systems
gyro_data::gyro_data
<::<
2012::2012
uhf::uhf
python::python
front::front
developments::developments
ports::ports
schemes::schemes
challenges::challenges
frequency::frequency
c++::c++
programmer::programmer
thermal-noise::thermal-noise
revisions::revisions
large::large
funding::funding
marcin::marcin
rx::rx
dsp::dsp
research::research
fellowship::fellowship
rf::rf
reader::reader
sensor::sensor
integrated::integrated
durgin::durgin
-11::-11
-10::-10
-13::-13
-12::-12
-15::-15
-14::-14
-17::-17
-16::-16
-19::-19
-18::-18
sensors::sensors
10-cm::10-cm
modularity::modularity
motion::motion
rf-frontend::rf-frontend
ism::ism
digitalsensor::digitalsensor
coding::coding
number::number
one::one
impossible::impossible
array::array
bi-static::bi-static
size::size
temperature::temperature
interact::interact
system::system
christopher.valenta::christopher.valenta
their::their
2::2
programmable::programmable
structures::structures
a::a
morys::morys
tool::tool
continuous::continuous
benets::benets
12::12
-oscillator::-oscillator
instruction::instruction
headers::headers
r::r
southern-states-cmd-iige-chemical-sensorelectro::southern-states-cmd-iige-chemical-sensorelectro
channelfilter::channelfilter
and::and
motivation::motivation
mind::mind
demonstration::demonstration
latency::latency
conversion::conversion
channel::channel
multiple::multiple
agenda::agenda
programmingport::programmingport
most::most
fcc::fcc
significant::significant
acknowledgements::acknowledgements
why::why
power-circuitryselect-source::power-circuitryselect-source
compe33on::compe33on
flow::flow
-24::-24
coding/telecommunications::coding/telecommunications
framer-sink::framer-sink
sensi3ve::sensi3ve
cheap::cheap
waveforms::waveforms
radio::radio
availability::availability
layout::layout
cots::cots
valenta::valenta
db::db
dc::dc
120::120
christopher::christopher
dr::dr
remove::remove
crc::crc
where::where
motherboard::motherboard
are::are
rfid-tag::rfid-tag
analog::analog
2.4::2.4
#::#
lots::lots
-spi::-spi
3::3
greg::greg
identification::identification
verilog::verilog
rfid-reader::rfid-reader
gtri::gtri
lfrx::lfrx
daughtercard::daughtercard
implementation/rapid::implementation/rapid
nature::nature
efficiency::efficiency
concentrated::concentrated
rffrontendrx::rffrontendrx
career::career
congurablebuzonstatus-leds::congurablebuzonstatus-leds
receiver::receiver
hardware/software::hardware/software
-usb-debugger::-usb-debugger
simple::simple
overview::overview
semi-passive::semi-passive
header::header
cw::cw
expensive::expensive
packetreceived-flag::packetreceived-flag
r.e.s.t::r.e.s.t
interest::interest
flexible::flexible
board::board
controlled::controlled
gas::gas
debugging/code::debugging/code
usrp::usrp
protocols::protocols
demodulates::demodulates
novel::novel
gnu::gnu
passivemotherboard::passivemotherboard
single::single
is::is
ii::ii
vs::vs
daughtercards::daughtercards
in::in
technology::technology
id::id
capture::capture
different::different
grant::grant
rfid-readertxso::rfid-readertxso
cross::cross
schematic::schematic
electro::electro
difficult::difficult
development::development
screenshot::screenshot
rfid::rfid
transceiver::transceiver
changing::changing
recent::recent
15.5::15.5
gatech.edu::gatech.edu
pows::pows
no::no
thingamagigawerks::thingamagigawerks
without::without
simulated::simulated
the::the
i2c::i2c
sensing::sensing
protocol::protocol
|s::|s
-powercircuitry::-powercircuitry
reset-buzon::reset-buzon
questions::questions
modulate::modulate
rapid::rapid
conclusions::conclusions
ease::ease
improvement::improvement
passive::passive
adc::adc
pow::pow
accelerometermicrocontroller::accelerometermicrocontroller
backscatter::backscatter
identical::identical
increased::increased
bands::bands
microcontroller::microcontroller
-etc::-etc
background::background
unique::unique
reusable::reusable
intel::intel
semi::semi
signal::signal
modulated::modulated
specific::specific
mhz::mhz
daughterboards::daughterboards
-mul+ple-access-techniques::-mul+ple-access-techniques
people::people
cognitive::cognitive
prototyping::prototyping
gyrometer::gyrometer
for::for
pj/bit::pj/bit
integration::integration
microwave::microwave
provides::provides
?::?
noise::noise
real-world::real-world
processing::processing
by::by
on::on
rf-switch::rf-switch
of::of
industry::industry
rfid/rfid-enabled::rfid/rfid-enabled
range::range
adc-voltage-reference::adc-voltage-reference
-ranging::-ranging
software::software
nsf::nsf
down::down
primarily::primarily
msp430::msp430
bazery::bazery
custom::custom
-increased-range-and-reliability::-increased-range-and-reliability
-msp430f5419::-msp430f5419
low::low
|dc-blockflicker-noise::|dc-blockflicker-noise
ettus::ettus
0546955::0546955
automa+cgain-control::automa+cgain-control
technologies::technologies
with::with
shackelford::shackelford
transmits::transmits
wisp::wisp
rffrontend::rffrontend
piece::piece
khz::khz
developing::developing
telecomm::telecomm
implications::implications
as::as
at::at
interchangable::interchangable
i/q-data::i/q-data
%::%
antenna::antenna
variety::variety
hobbyists::hobbyists
other::other
digital::digital
n200::n200
users::users
backscattered::backscattered
students::students
variable::variable
time::time
demodulator::demodulator
