::
limited::limited
dynamic::dynamic
four::four
consists::consists
centimeter::centimeter
looking::looking
under::under
@::@
regional::regional
every::every
affect::affect
vector::vector
pre-tests::pre-tests
budget::budget
surrounding::surrounding
likely::likely
machines::machines
even::even
errors::errors
+::+
selected::selected
supplied::supplied
above::above
conduct::conduct
new::new
increasing::increasing
never::never
reported::reported
china::china
granularity::granularity
active::active
100::100
of-sight::of-sight
obtained::obtained
study::study
changed::changed
reports::reports
advantages::advantages
suitable::suitable
changes::changes
00-02-02::00-02-02
explained::explained
highly::highly
total::total
would::would
call::call
until::until
slocombe::slocombe
701710::701710
award::award
real-time::real-time
90::90
ward::ward
95::95
circumstances::circumstances
1992::1992
ma::ma
1994::1994
1997::1997
1999::1999
1998::1998
setup::setup
work::work
mi::mi
itself::itself
install::install
example::example
::
indicated::indicated
give::give
organized::organized
want::want
keep::keep
guarantee::guarantee
hoc::hoc
carriers::carriers
provide::provide
feature::feature
multi-path::multi-path
machine::machine
how::how
methodology::methodology
classify::classify
lan::lan
after::after
lab::lab
lau::lau
parallel::parallel
types::types
hightower2000indoor/hightower2000indoor.pdf::hightower2000indoor/hightower2000indoor.pdf
attempt::attempt
third::third
complexity::complexity
green::green
decreasing::decreasing
first::first
order::order
office::office
telecom::telecom
over::over
before::before
better::better
overcome::overcome
versus::versus
then::then
them::them
similar::similar
they::they
microsoft.com/padmanab/papers/infocom2000.pdf::microsoft.com/padmanab/papers/infocom2000.pdf
pervasive::pervasive
papers/rfid_basics_primer.htm::papers/rfid_basics_primer.htm
netherlands::netherlands
program/api::program/api
each::each
one-hour::one-hour
prohibit::prohibit
durability::durability
series::series
spider::spider
lateration::lateration
laboratory::laboratory
array::array
network::network
quantify::quantify
01-08-03::01-08-03
rf::rf
reader::reader
engineer::engineer
rj::rj
linear::linear
associate::associate
given::given
free::free
commercially::commercially
subtended::subtended
acm/ieee::acm/ieee
estimate::estimate
moving::moving
speeds::speeds
purpose::purpose
features::features
mingo::mingo
primary::primary
another::another
approximately::approximately
needed::needed
enhancing::enhancing
radars::radars
serve::serve
somewhat::somewhat
distance::distance
pre-determined::pre-determined
second::second
project::project
enables::enables
bridge::bridge
modulating::modulating
boston::boston
seen::seen
latency::latency
strength::strength
snow::snow
causing::causing
forces::forces
transmit::transmit
effectiveness::effectiveness
transactions::transactions
object::object
anatomy::anatomy
acknowledgements::acknowledgements
inconsistency::inconsistency
professor::professor
partition::partition
m::m
points::points
v.n::v.n
random::random
infrared::infrared
radio::radio
7.5::7.5
keywords::keywords
//www.uk:://www.uk
availability::availability
busy::busy
layout::layout
proposed::proposed
implementation::implementation
explain::explain
do::do
despite::despite
report::report
impractical::impractical
onboard::onboard
dr::dr
bat::bat
nicely::nicely
priyantha::priyantha
bay::bay
automatic::automatic
3:00::3:00
respond::respond
::
reference::reference
detection::detection
result::result
fail::fail
sub-regions::sub-regions
best::best
techniques::techniques
r::r
simplest::simplest
approach::approach
//www:://www
we::we
wa::wa
nature::nature
however::however
wi::wi
location-support::location-support
modeling::modeling
improve::improve
received::received
essentially::essentially
adapter::adapter
conclusions::conclusions
receiver::receiver
suggest::suggest
tough::tough
location-sensing::location-sensing
telecommunications::telecommunications
conference::conference
square-feet::square-feet
basis::basis
three::three
been::been
much::much
interest::interest
basic::basic
expected::expected
flexible::flexible
life::life
hkust6161/03e::hkust6161/03e
worked::worked
lionel::lionel
applied::applied
commerce::commerce
exception::exception
east::east
n::n
aim::aim
euclidean::euclidean
near::near
suppose::suppose
k::k
high-unit-value::high-unit-value
ip::ip
is::is
it::it
in::in
comparative::comparative
seattle::seattle
id::id
if::if
hong::hong
things::things
make::make
cumulative::cumulative
several::several
satellite::satellite
nic::nic
cost-effectiveness::cost-effectiveness
cycle::cycle
nlos::nlos
off-the-shelf::off-the-shelf
academic::academic
contact::contact
the::the
protocol::protocol
just::just
assigned::assigned
human::human
yet::yet
adding::adding
candidate::candidate
had::had
passive::passive
easy::easy
has::has
hightower::hightower
possible::possible
possibly::possibly
unique::unique
50::50
specific::specific
ph.d::ph.d
night::night
security::security
deal::deal
people::people
successfully::successfully
unnecessary::unnecessary
captive::captive
meters::meters
ignore::ignore
tracked::tracked
for::for
collect::collect
electromagnetic::electromagnetic
daytime::daytime
contributing::contributing
fog::fog
::
barcode::barcode
emits::emits
bahl::bahl
o::o
cs.ust.hk::cs.ust.hk
satellite-based::satellite-based
runtime::runtime
obtaining::obtaining
bats::bats
reducing::reducing
support::support
approximate::approximate
way::way
overhead::overhead
was::was
head::head
offering::offering
offer::offer
wireless::wireless
true::true
inside::inside
maximum::maximum
devices::devices
//people:://people
feet::feet
150::150
computing::computing
homogenous::homogenous
abstract::abstract
harter::harter
interferences::interferences
physical::physical
ni::ni
no::no
when::when
chakraborty::chakraborty
interested::interested
digital::digital
intend::intend
update::update
alleviated::alleviated
msu.edu::msu.edu
interval::interval
together::together
reception::reception
time::time
neighbors::neighbors
concept::concept
remarkable::remarkable
global::global
manager::manager
ice::ice
inverse::inverse
depend::depend
technique::technique
environment::environment
must::must
indoor::indoor
advantage::advantage
frequencies::frequencies
keeping::keeping
choice::choice
1995::1995
minute::minute
room::room
perceived::perceived
short-range::short-range
level::level
turns::turns
p::p
unexpected::unexpected
cost::cost
current::current
buttoncell::buttoncell
international::international
badge::badge
location-aware::location-aware
groups::groups
along::along
change::change
sending::sending
studied::studied
falcao::falcao
usually::usually
heubler::heubler
navigation::navigation
useful::useful
extra::extra
users/objects::users/objects
chaired::chaired
operational::operational
market::market
gibbons::gibbons
high-speed::high-speed
suggestions::suggestions
equipped::equipped
riod::riod
cases::cases
ibm::ibm
values::values
can::can
growing::growing
location-based::location-based
placements::placements
nearest::nearest
figure::figure
weighting::weighting
incremental::incremental
dropped::dropped
7-character::7-character
s2::s2
divided::divided
1::1
optimal::optimal
parameter::parameter
product::product
influenced::influenced
may::may
applications::applications
designed::designed
date::date
such::such
data::data
commodity::commodity
si::si
so::so
sn::sn
tagged::tagged
mainly::mainly
kong::kong
non-line::non-line
experiments::experiments
statistical::statistical
still::still
ieee::ieee
group::group
decreases::decreases
main::main
chiesa::chiesa
thereby::thereby
introduce::introduce
not::not
now::now
discuss::discuss
3243::3243
quarter::quarter
em::em
square::square
significantly::significantly
ej::ej
ef::ef
et::et
ultimately::ultimately
factors::factors
interference::interference
increase::increase
internet::internet
formula::formula
sensor::sensor
viable::viable
shows::shows
noessel::noessel
earlier::earlier
mechanisms::mechanisms
overheads::overheads
quite::quite
complicated::complicated
besides::besides
e1::e1
e2::e2
place::place
1000::1000
xi::xi
tagtracker::tagtracker
one::one
directly::directly
//rfcode.com/productsframe.asp:://rfcode.com/productsframe.asp
size::size
little::little
5.935.97::5.935.97
mobicom::mobicom
yiu::yiu
2::2
cost-effective::cost-effective
structures::structures
gives::gives
that::that
continuous::continuous
accurately::accurately
eliminated::eliminated
than::than
11::11
10::10
13::13
12::12
15::15
14::14
16::16
18::18
require::require
10:00::10:00
future::future
and::and
802.11b::802.11b
dynamically::dynamically
locations::locations
edu/homes/jeffro/pubs/hightower2001design/::edu/homes/jeffro/pubs/hightower2001design/
any::any
manufacturers::manufacturers
infocom::infocom
note::note
clearwater::clearwater
potential::potential
take::take
objective::objective
performance::performance
strengths::strengths
multiple::multiple
track::track
operate::operate
considered::considered
average::average
later::later
professional::professional
show::show
ratio::ratio
interaction-ivrea.it/c.noessel/rfid/research::interaction-ivrea.it/c.noessel/rfid/research
daily::daily
proportion::proportion
lansing::lansing
only::only
taxonomy::taxonomy
assistant::assistant
lighter::lighter
reveal::reveal
ad-hoc::ad-hoc
morning::morning
where::where
middleware::middleware
borriello::borriello
physically::physically
relative::relative
detect::detect
ways::ways
3::3
bureau::bureau
between::between
infrastructure::infrastructure
august::august
websphere::websphere
lauyiuch::lauyiuch
awards::awards
yunhao::yunhao
configuring::configuring
many::many
region::region
hours::hours
tracking/moving::tracking/moving
enabling::enabling
propagation::propagation
s::s
authoring::authoring
among::among
tradeoff::tradeoff
effective::effective
kowloon::kowloon
moreover::moreover
combines::combines
west::west
locally::locally
eia9911074::eia9911074
prototype::prototype
hardly::hardly
500::500
former::former
those::those
case::case
these::these
promising::promising
investigating::investigating
conferences::conferences
technology::technology
different::different
develop::develop
author::author
same::same
configurable::configurable
html::html
events::events
visually::visually
investigated::investigated
ultra-wideband::ultra-wideband
rfid::rfid
director::director
transceiver::transceiver
wired::wired
tracking::tracking
x0::x0
roughly::roughly
k::k
without::without
components::components
coordinate::coordinate
1/ei2::1/ei2
researchers::researchers
being::being
except::except
improvement::improvement
4::4
overview::overview
real::real
around::around
read::read
papers::papers
early::early
grid::grid
world::world
postal::postal
furniture::furniture
reduces::reduces
server::server
t::t
occasions::occasions
reduced::reduced
satisfactory::satisfactory
specified::specified
users::users
provided::provided
recorded::recorded
critical::critical
provides::provides
assembly::assembly
power::power
seconds::seconds
manufactured::manufactured
communicate::communicate
utilities::utilities
padmanabhan::padmanabhan
accommodated::accommodated
i=1::i=1
comparison::comparison
central::central
stations::stations
of::of
industry::industry
discussed::discussed
acm::acm
practical::practical
greatly::greatly
neighbor::neighbor
or::or
cambridge::cambridge
communication::communication
references::references
determine::determine
log::log
area::area
there::there
start::start
detectable::detectable
lot::lot
aidc::aidc
complete::complete
respec::respec
reduce::reduce
technologies::technologies
with::with
embedded::embedded
gone::gone
ad::ad
certain::certain
am::am
al::al
general::general
as::as
scanned::scanned
at::at
file::file
lifetime::lifetime
again::again
4.1::4.1
ideally::ideally
antenna::antenna
4.2::4.2
field::field
5::5
weights::weights
separate::separate
//research.microsoft:://research.microsoft
includes::includes
important::important
suited::suited
included::included
delineate::delineate
u::u
original::original
all::all
surrounded::surrounded
consider::consider
lack::lack
research::research
3-dimensional::3-dimensional
//www.cs.washington:://www.cs.washington
diffuse::diffuse
to::to
nodes::nodes
activities::activities
sitting::sitting
very::very
worst::worst
difference::difference
evaluation::evaluation
large::large
5.1::5.1
adjust::adjust
small::small
employing::employing
rate::rate
design::design
further::further
what::what
section::section
brief::brief
movement::movement
tags::tags
ranges::ranges
operating::operating
i.e::i.e
standard::standard
allows::allows
uniquely::uniquely
via::via
analyzing::analyzing
1/ei::1/ei
two::two
comparing::comparing
6::6
more::more
israel::israel
fellow::fellow
tester::tester
tested::tested
varying::varying
known::known
none::none
hour::hour
science::science
equation::equation
v::v
cse.msu.edu::cse.msu.edu
challenging::challenging
scan::scan
share::share
collision::collision
//www.research:://www.research
sense::sense
information::information
5.2::5.2
5.3::5.3
5.4::5.4
goal::goal
cse::cse
acts::acts
ubiquitous::ubiquitous
tried::tried
communicating::communicating
reflect::reflect
faculty::faculty
710::710
a::a
specifying::specifying
fundamental::fundamental
patil::patil
help::help
ith::ith
developed::developed
trade::trade
radar::radar
paper::paper
through::through
y0::y0
its::its
environmentally::environmentally
24::24
1-nearest::1-nearest
detected::detected
systems::systems
might::might
yi::yi
reflected::reflected
framework::framework
tsinghua::tsinghua
association::association
easily::easily
purdue::purdue
always::always
presented::presented
sub-region::sub-region
capability::capability
inherent::inherent
repeating::repeating
weight::weight
positioned::positioned
idea::idea
exorbitant::exorbitant
extended::extended
expect::expect
measurement::measurement
discrete::discrete
since::since
denotes::denotes
5968::5968
7::7
issue::issue
occurs::occurs
found::found
difficulty::difficulty
reason::reason
base::base
reconfigure::reconfigure
hightower2001design.pdf::hightower2001design.pdf
positioning::positioning
conducted::conducted
tel-aviv::tel-aviv
circuit::circuit
major::major
probability::probability
radical::radical
number::number
well-known::well-known
tively::tively
introduction::introduction
reader/interrogator::reader/interrogator
5th::5th
least::least
paint::paint
assumption::assumption
gps::gps
relationship::relationship
part::part
believe::believe
b::b
determined::determined
supposed::supposed
outdoors::outdoors
edu/homes/jeffro/pubs/hightower2001survey/::edu/homes/jeffro/pubs/hightower2001survey/
outstanding::outstanding
randomly::randomly
categorized::categorized
paths::paths
built::built
depending::depending
also::also
empirically::empirically
costs::costs
build::build
peer-to-peer::peer-to-peer
added::added
reach::reach
most::most
significant::significant
services::services
infrastructures::infrastructures
mobile::mobile
sometimes::sometimes
cover::cover
traditional::traditional
microsoft::microsoft
hopper::hopper
networks::networks
impact::impact
distributed::distributed
olivetti::olivetti
factor::factor
8::8
proximity::proximity
his::his
dependent::dependent
cheaper::cheaper
line-of-sight::line-of-sight
liu::liu
longest::longest
during::during
48824::48824
investigate::investigate
common::common
x::x
locating::locating
scanning::scanning
set::set
achieved::achieved
see::see
individual::individual
are::are
close::close
probable::probable
currently::currently
smallest::smallest
various::various
consecutive::consecutive
conditions::conditions
available::available
interface::interface
both::both
c::c
improved::improved
annual::annual
foreign::foreign
improves::improves
context::context
inter-tag::inter-tag
whole::whole
experimental::experimental
point::point
reasons::reasons
others::others
corresponds::corresponds
dimensional::dimensional
expensive::expensive
pp::pp
802.11::802.11
enhancements::enhancements
create::create
due::due
describes::describes
pe::pe
collected::collected
pm::pm
irgp::irgp
handling::handling
reliable::reliable
48-bit::48-bit
empirical::empirical
technical::technical
while::while
optimization::optimization
behavior::behavior
error::error
obstacle::obstacle
examine::examine
grant::grant
shorter::shorter
virtually::virtually
widely::widely
peoples::peoples
9::9
survey::survey
higher::higher
development::development
used::used
triangulation::triangulation
levels::levels
uses::uses
user::user
lower::lower
b.s::b.s
studies::studies
analysis::analysis
obviously::obviously
landmarc::landmarc
person::person
y::y
spend::spend
b.e::b.e
distances::distances
competitive::competitive
shape::shape
using::using
alternative::alternative
kluwer::kluwer
readers::readers
signals::signals
source::source
rgc::rgc
location::location
aetherwire::aetherwire
useless::useless
march::march
evaluate::evaluate
unlimited::unlimited
aggregation::aggregation
projects::projects
wirelessly::wirelessly
d::d
signal::signal
shapes::shapes
communications::communications
popular::popular
4.3-meter::4.3-meter
essential::essential
often::often
some::some
prototyping::prototyping
examples::examples
sight::sight
delivered::delivered
affects::affects
decision::decision
though::though
per::per
eliminate::eliminate
either::either
308::308
be::be
processing::processing
step::step
percentile::percentile
steggles::steggles
by::by
constraint::constraint
ids::ids
range::range
consequently::consequently
into::into
within::within
nsf::nsf
primarily::primarily
proportional::proportional
next::next
statistics::statistics
conceivably::conceivably
retrieving::retrieving
placing::placing
long::long
vendors::vendors
subregions::subregions
properly::properly
circuits::circuits
uw::uw
up::up
us::us
continuously::continuously
sopieva::sopieva
storing::storing
defined::defined
influence::influence
engineering::engineering
pre-programmed::pre-programmed
application::application
electrical::electrical
department::department
hightower2001survey.pdf::hightower2001survey.pdf
problems::problems
replace::replace
meaning::meaning
e::e
algorithm::algorithm
required::required
orbit::orbit
2002::2002
2003::2003
2000::2000
2001::2001
lafayette::lafayette
2004::2004
requires::requires
having::having
code::code
results::results
existing::existing
illustrated::illustrated
issues::issues
send::send
helps::helps
include::include
sent::sent
pdas::pdas
wave::wave
transmission::transmission
positions::positions
mumbai::mumbai
configurations::configurations
limitations::limitations
smaller::smaller
detection-rang::detection-rang
concludes::concludes
dynamics::dynamics
giving::giving
find::find
cell::cell
experiment::experiment
3d::3d
proliferation::proliferation
measurements::measurements
degree::degree
respectively::respectively
gathered::gathered
n.b::n.b
desired::desired
objects::objects
let::let
webster::webster
//www.aetherwire.com/:://www.aetherwire.com/
extreme::extreme
great::great
genz::genz
receive::receive
30::30
35::35
products::products
implement::implement
buffered::buffered
formulated::formulated
addresses::addresses
deputy::deputy
context-aware::context-aware
spoton::spoton
addressed::addressed
api::api
1/k::1/k
standing::standing
use::use
from::from
usa::usa
&::&
cho::cho
few::few
milliseconds::milliseconds
on::on
started::started
//www.garmin.com/:://www.garmin.com/
balakrishnan::balakrishnan
socket::socket
f::f
this::this
obvious::obvious
www.cs.washington.edu/homes/jeffro/pubs/::www.cs.washington.edu/homes/jeffro/pubs/
control::control
beijing::beijing
weaker::weaker
process::process
inaccessible::inaccessible
effectively::effectively
tag::tag
employs::employs
regions::regions
located::located
instead::instead
fostered::fostered
specifications::specifications
collection::collection
realizes::realizes
allow::allow
s1::s1
patilabh::patilabh
www.aimglobal.org/technologies/rfid/resources/::www.aimglobal.org/technologies/rfid/resources/
move::move
meter::meter
including::including
mentioned::mentioned
chosen::chosen
li::li
estimating::estimating
permanent::permanent
choose::choose
defining::defining
practice::practice
front::front
realize::realize
february::february
university::university
identified::identified
unpredictable::unpredictable
transmitted::transmitted
mode::mode
constraints::constraints
subset::subset
708::708
709::709
704::704
705::705
706::706
707::707
buildings::buildings
702::702
703::703
91102::91102
society::society
frequency::frequency
static::static
measure::measure
our::our
special::special
out::out
obstructions::obstructions
performs::performs
electronics::electronics
integrated::integrated
8e::8e
approaches::approaches
shortest::shortest
g::g
determining::determining
could::could
times::times
hence::hence
diminishes::diminishes
2-nearest::2-nearest
scene::scene
e-post::e-post
intuitively::intuitively
management::management
unknown::unknown
system::system
relations::relations
their::their
interests::interests
configure::configure
explanation::explanation
environmental::environmental
india::india
providing::providing
distinguished::distinguished
collecting::collecting
unchanged::unchanged
ultrasonic::ultrasonic
have::have
need::need
constrained::constrained
angle::angle
able::able
mechanism::mechanism
which::which
subject::subject
=::=
accuracy::accuracy
overlapping::overlapping
preliminary::preliminary
device::device
why::why
placement::placement
neighboring::neighboring
proceedings::proceedings
normally::normally
fact::fact
selection::selection
supported::supported
principal::principal
nearer::nearer
based::based
earned::earned
sparks::sparks
vakili::vakili
should::should
emitting::emitting
achieve::achieve
means::means
midnight::midnight
michigan::michigan
overall::overall
ones::ones
years::years
chips::chips
following::following
processes::processes
h::h
processed::processed
rf-based::rf-based
contain::contain
fixed::fixed
requirement::requirement
computed::computed
time/tag::time/tag
configured::configured
in-building::in-building
computes::computes
computer::computer
state::state
identification::identification
neither::neither
publishers::publishers
ability::ability
emitted::emitted
wj::wj
efficiency::efficiency
key::key
configuration::configuration
problem::problem
restrictions::restrictions
taking::taking
figures::figures
estimation::estimation
aboutgps/::aboutgps/
cm::cm
environments::environments
coordinates::coordinates
respect::respect
addition::addition
utilizing::utilizing
define::define
contribute::contribute
corresponding::corresponding
2.372.65::2.372.65
aimglobal.org/technologies/rfid/::aimglobal.org/technologies/rfid/
abhishek::abhishek
an::an
garmin::garmin
present::present
balachandran::balachandran
value::value
will::will
thus::thus
hardware::hardware
landmarks::landmarks
member::member
largest::largest
http::http
cubic::cubic
reporting::reporting
effect::effect
automation::automation
architectures::architectures
student::student
//:://
i::i
well::well
position::position
sensing::sensing
less::less
accurate::accurate
obtain::obtain
landarc::landarc
satellites::satellites
batteries::batteries
web::web
density::density
absorption::absorption
battery::battery
add::add
extends::extends
identical::identical
increased::increased
increases::increases
know::know
deployment::deployment
press::press
necessary::necessary
like::like
mhz::mhz
become::become
works::works
page::page
accessible::accessible
because::because
concentrator::concentrator
home::home
avoid::avoid
e-mail::e-mail
does::does
locate::locate
noise::noise
although::although
offset::offset
described::described
about::about
actual::actual
research.att.com/bat/::research.att.com/bat/
getting::getting
introduces::introduces
compatible::compatible
locationsensing::locationsensing
software::software
equally::equally
own::own
coverage::coverage
washington::washington
ultrasound::ultrasound
k-nearest::k-nearest
networking::networking
1980::1980
1981::1981
function::function
building::building
cricket::cricket
but::but
repeated::repeated
related::related
convergence::convergence
bluetooth::bluetooth
he::he
made::made
compute::compute
whether::whether
j::j
variations::variations
placed::placed
below::below
limit::limit
demonstrate::demonstrate
distribution::distribution
com/bahl/papers/pdf/msr-tr-2000-12.pdf::com/bahl/papers/pdf/msr-tr-2000-12.pdf
denote::denote
inc::inc
compared::compared
48::48
calibration::calibration
corporation::corporation
percent::percent
other::other
lookup::lookup
repeat::repeat
m.s::m.s
shown::shown
variation::variation
m.a::m.a
wire-connection::wire-connection
space::space
compete::compete
time-of-flight::time-of-flight
