::
limited::limited
secondly::secondly
magnetic::magnetic
assembled::assembled
relationships::relationships
whose::whose
calculate::calculate
electricity::electricity
tween::tween
under::under
@::@
7dbi::7dbi
handling::handling
every::every
affect::affect
bringing::bringing
vast::vast
companies::companies
solution::solution
10k::10k
consistent::consistent
approximation::approximation
10x::10x
street::street
implemented::implemented
even::even
specification::specification
above::above
new::new
increasing::increasing
met::met
protection::protection
active::active
100::100
logarithmic::logarithmic
obtained::obtained
items::items
study::study
credit::credit
military::military
suitable::suitable
issuers::issuers
highly::highly
modulated::modulated
unit::unit
marketers::marketers
would::would
chooses::chooses
therefore::therefore
passport::passport
recommend::recommend
type::type
tell::tell
underwear::underwear
curvature::curvature
burglaries::burglaries
must::must
me::me
word::word
rights::rights
work::work
install::install
akin::akin
root::root
example::example
give::give
currency::currency
want::want
feasible::feasible
altitudes::altitudes
absolute::absolute
end::end
26dbi::26dbi
thing::thing
provide::provide
verify::verify
travel::travel
damage::damage
revisit::revisit
how::how
kilowatt::kilowatt
earlier::earlier
minimized::minimized
lightly-modified::lightly-modified
types::types
las::las
effective::effective
appreciate::appreciate
ultimate::ultimate
enter::enter
eirp::eirp
operate::operate
wing::wing
standard-issue::standard-issue
restriction::restriction
amplifying::amplifying
co-operating::co-operating
transmitters::transmitters
before::before
attenuators::attenuators
fit::fit
directional::directional
personal::personal
exhibits::exhibits
comprehend::comprehend
better::better
400::400
hidden::hidden
eventually::eventually
them::them
tourist::tourist
combination::combination
safe::safe
break::break
band::band
effects::effects
they::they
reasonable::reasonable
each::each
side::side
upc::upc
combining::combining
navy::navy
overwrite::overwrite
driving::driving
realtime::realtime
restricted::restricted
dsp::dsp
rf::rf
reader::reader
got::got
resistor::resistor
sheer::sheer
standard::standard
hand::hand
exposing::exposing
created::created
silicon::silicon
walmart::walmart
ism::ism
industrial::industrial
shopper::shopper
primary::primary
another::another
illustrate::illustrate
likely::likely
top::top
girls::girls
returns::returns
approximately::approximately
needed::needed
too::too
ranging::ranging
damaging::damaging
urban::urban
bouncing::bouncing
took::took
incur::incur
western::western
somewhat::somewhat
abandoning::abandoning
distance::distance
target::target
second::second
final::final
classes::classes
milliwatts::milliwatts
sees::sees
goodspeed::goodspeed
modern::modern
spectrum::spectrum
manner::manner
relatively::relatively
forced::forced
strength::strength
convenient::convenient
firmware::firmware
isolated::isolated
recommended::recommended
absorbed::absorbed
doors::doors
transmit::transmit
though::though
object::object
regular::regular
coil::coil
medical::medical
principle::principle
20dbm::20dbm
labels::labels
radio::radio
solutions::solutions
earth::earth
analogue::analogue
sewn::sewn
implementation::implementation
situations::situations
900mhz::900mhz
do::do
10::10
low-noise::low-noise
db::db
dc::dc
comply::comply
countries::countries
fields::fields
reference::reference
sensitivity::sensitivity
testing::testing
result::result
best::best
techniques::techniques
said::said
away::away
wikipedia::wikipedia
mug::mug
unable::unable
simplest::simplest
conductive::conductive
approach::approach
we::we
terms::terms
maximums::maximums
nature::nature
handful::handful
however::however
improve::improve
received::received
credit-card::credit-card
readers::readers
against::against
receives::receives
receiver::receiver
trunk::trunk
height::height
represented::represented
canyon::canyon
initiative::initiative
three::three
tiny::tiny
quickly::quickly
much::much
basic::basic
expected::expected
containers::containers
life::life
quantities::quantities
uncommon::uncommon
attacker::attacker
usrp::usrp
gnu::gnu
air::air
near::near
mexico::mexico
is::is
it::it
in::in
id::id
if::if
containing::containing
things::things
make::make
complex::complex
potentially::potentially
inventory::inventory
decibel::decibel
several::several
pick::pick
hysteresis::hysteresis
tune::tune
off-the-shelf::off-the-shelf
kept::kept
timeouts::timeouts
the::the
epc::epc
just::just
in-band::in-band
identify::identify
modulate::modulate
electronically::electronically
previous::previous
adding::adding
transformer::transformer
unique::unique
ham::ham
short-circuit::short-circuit
had::had
easy::easy
has::has
bands::bands
tricking::tricking
progressed::progressed
possible::possible
burns::burns
advanced::advanced
apart::apart
ism-band::ism-band
35dbi::35dbi
50::50
specific::specific
steps::steps
night::night
security::security
people::people
sends::sends
successfully::successfully
ironically::ironically
callsign::callsign
10dbi::10dbi
for::for
/::/
xr400::xr400
foe::foe
attacks::attacks
citizens::citizens
ensure::ensure
16.5dbm::16.5dbm
thinner::thinner
civil::civil
obtaining::obtaining
down::down
//bit.ly/ce3fwf:://bit.ly/ce3fwf
reducing::reducing
altitude::altitude
initial::initial
why::why
accordingly::accordingly
way::way
18.5dbm::18.5dbm
was::was
amateur::amateur
form::form
offer::offer
garments::garments
hemisphere::hemisphere
true::true
arrays::arrays
prevents::prevents
inside::inside
maximum::maximum
devices::devices
until::until
stages::stages
on-air::on-air
proved::proved
hams::hams
16db::16db
covers::covers
exist::exist
trip::trip
no::no
generally::generally
reality::reality
digital::digital
test::test
's::'s
connect::connect
'd::'d
transfers::transfers
'm::'m
faster::faster
open-circuit::open-circuit
assume::assume
together::together
//bit.ly/9fcduv:://bit.ly/9fcduv
sniffer::sniffer
chain::chain
focus::focus
switches::switches
mile::mile
inverse::inverse
essentials::essentials
everything::everything
environment::environment
finally::finally
compensate::compensate
frequencies::frequencies
vegas::vegas
presented::presented
did::did
standards::standards
travels::travels
p::p
round::round
upper::upper
cost::cost
incrementally::incrementally
port::port
havoc::havoc
current::current
international::international
satisfy::satisfy
understanding::understanding
groups::groups
address::address
12.75db::12.75db
appears::appears
supplying::supplying
box::box
canadian::canadian
my::my
overrides::overrides
wherever::wherever
20mw::20mw
exams::exams
domains::domains
useful::useful
extra::extra
predictions::predictions
scenarios::scenarios
scope::scope
theoretical::theoretical
introducing::introducing
degrade::degrade
given::given
easiest::easiest
originally::originally
can::can
following::following
making::making
figure::figure
pauses::pauses
nexus::nexus
allowed::allowed
clothing::clothing
requirements::requirements
deserves::deserves
1::1
till::till
square-root::square-root
map::map
product::product
explores::explores
information::information
may::may
max::max
spot::spot
//bit.ly/dvhfnr:://bit.ly/dvhfnr
4th::4th
designed::designed
date::date
such::such
data::data
long-range::long-range
yielding::yielding
so::so
increase::increase
talk::talk
typical::typical
tagged::tagged
breaking::breaking
course::course
in-store::in-store
multipath::multipath
adhesive::adhesive
group::group
interesting::interesting
window::window
70dbi::70dbi
ours::ours
main::main
introduce::introduce
transmissions::transmissions
not::not
now::now
name::name
gen2-based::gen2-based
entirely::entirely
20+30=50dbm::20+30=50dbm
square::square
significantly::significantly
ee::ee
unlock::unlock
wavelength::wavelength
affluent::affluent
neighbourhood::neighbourhood
small-scale::small-scale
space::space
interference::interference
looking::looking
100w::100w
viable::viable
inevitably::inevitably
after::after
theory::theory
near-perfect::near-perfect
imaginable::imaginable
complicated::complicated
inductive::inductive
inevitable::inevitable
card::card
care::care
advance::advance
watts::watts
turn::turn
best-known::best-known
plane::plane
think::think
1000::1000
constantly::constantly
high-power::high-power
coming::coming
-110::-110
one::one
americans::americans
fast::fast
directly::directly
carry::carry
impossible::impossible
array::array
low-earth::low-earth
angular::angular
city::city
little::little
anyone::anyone
cooling::cooling
2::2
shoppers::shoppers
white::white
friend::friend
gives::gives
that::that
huh::huh
artifact::artifact
1500w::1500w
than::than
coefficients::coefficients
population::population
wide::wide
15::15
14::14
defcon::defcon
require::require
yagis::yagis
r::r
were::were
cards::cards
and::and
turned::turned
say::say
any::any
downwards::downwards
note::note
equipment::equipment
ideal::ideal
potential::potential
take::take
online::online
destroy::destroy
channel::channel
begin::begin
sure::sure
track::track
price::price
knew::knew
fcc::fcc
importantly::importantly
successive::successive
pair::pair
paget::paget
surprising::surprising
later::later
order::order
typically::typically
precise::precise
drastically::drastically
//bit.ly/bifzjb:://bit.ly/bifzjb
threshold::threshold
ground::ground
slot::slot
ratio::ratio
3::3
only::only
parabolic::parabolic
over::over
first::first
instant-messaging::instant-messaging
get::get
secondary::secondary
241km::241km
yield::yield
miles::miles
predicted::predicted
where::where
burst::burst
lna::lna
purest::purest
radiates::radiates
detect::detect
ways::ways
label::label
enough::enough
radiated::radiated
between::between
reading::reading
across::across
analyzer::analyzer
20::20
come::come
many::many
according::according
amateurs::amateurs
comes::comes
among::among
filtering::filtering
afterwards::afterwards
67::67
69::69
50+10=60dbm::50+10=60dbm
sensible::sensible
combiner::combiner
capable::capable
vacation::vacation
combined::combined
902-928mhz::902-928mhz
500::500
direction::direction
shopping::shopping
-140::-140
thousand::thousand
careful::careful
those::those
case::case
stacked::stacked
these::these
n't::n't
residence::residence
prevalence::prevalence
characteristics::characteristics
equal::equal
someone::someone
clutter::clutter
technology::technology
different::different
author::author
tour::tour
same::same
check::check
buys::buys
document::document
assist::assist
running::running
changing::changing
validate::validate
tracking::tracking
largely::largely
minimize::minimize
without::without
transmitting::transmitting
when::when
actions::actions
kill::kill
guides::guides
-20dbm::-20dbm
extreme-range::extreme-range
loop-type::loop-type
generator::generator
4::4
real::real
around::around
rules::rules
disable::disable
confines::confines
vacuum::vacuum
amp::amp
kilowatts::kilowatts
've::'ve
facing::facing
chamber::chamber
benefit::benefit
t::t
always::always
federally-issued::federally-issued
output::output
downward::downward
reduced::reduced
specified::specified
legal::legal
critical::critical
provides::provides
measuring::measuring
scientific::scientific
power::power
seconds::seconds
on::on
conducting::conducting
stations::stations
of::of
industry::industry
practical::practical
greatly::greatly
mixed::mixed
2x2::2x2
or::or
communication::communication
low-power::low-power
determine::determine
technically::technically
area::area
removing::removing
there::there
desert::desert
start::start
lot::lot
strict::strict
passports::passports
9::9
impedance::impedance
technologies::technologies
with::with
longer::longer
abused::abused
arranged::arranged
emissions::emissions
obtains::obtains
general::general
5dbm::5dbm
examine::examine
intro::intro
at::at
again::again
antenna::antenna
drivers::drivers
field::field
5::5
mathematics::mathematics
you::you
symbol::symbol
time::time
includes::includes
important::important
peak::peak
chris::chris
remote::remote
ivegotta::ivegotta
vehicle-mounted::vehicle-mounted
once::once
resolution::resolution
original::original
//bit.ly/cdelvf:://bit.ly/cdelvf
represent::represent
all::all
consider::consider
pointing::pointing
thingmagic::thingmagic
duplicates::duplicates
caused::caused
lack::lack
code::code
dish::dish
imme::imme
prefixes::prefixes
to::to
locales::locales
presentation::presentation
returned::returned
returning::returning
very::very
1,500::1,500
offaxis::offaxis
arecibo::arecibo
list::list
large::large
small::small
i'll::i'll
pass::pass
further::further
what::what
swamps::swamps
version::version
learned::learned
public::public
movement::movement
tags::tags
modify::modify
answers::answers
mule::mule
ranges::ranges
operating::operating
excess::excess
directions::directions
i.e::i.e
strong::strong
search::search
compliance::compliance
allows::allows
amount::amount
published::published
action::action
narrow::narrow
requiring::requiring
self-imposed::self-imposed
aimed::aimed
readily::readily
takes::takes
etc::etc
two::two
comparing::comparing
6::6
taken::taken
minor::minor
more::more
knows::knows
operators::operators
controlling::controlling
known::known
equation::equation
shelves::shelves
sweeps::sweeps
guards::guards
mall::mall
learn::learn
sentri::sentri
purchases::purchases
spenders::spenders
scan::scan
states::states
minimum::minimum
numbers::numbers
purchased::purchased
lacks::lacks
!::!
filter::filter
acts::acts
reject::reject
explains::explains
ubiquitous::ubiquitous
derived::derived
reflect::reflect
851-942mhz::851-942mhz
waves::waves
response::response
a::a
fundamental::fundamental
microseconds::microseconds
help::help
disables::disables
soon::soon
installed::installed
disabled::disabled
radar::radar
paper::paper
through::through
out-of-band::out-of-band
hell::hell
surveillance::surveillance
its::its
24::24
hundredth::hundredth
rapidly::rapidly
solving::solving
blurring::blurring
actually::actually
late::late
systems::systems
bypass::bypass
recombined::recombined
uhf::uhf
good::good
return::return
reflected::reflected
48.5dbm::48.5dbm
sweeping::sweeping
speculate::speculate
bigger::bigger
easily::easily
fully::fully
level::level
iff::iff
found::found
referred::referred
generation::generation
energy::energy
expect::expect
measurement::measurement
operation::operation
beyond::beyond
really::really
leave::leave
item::item
since::since
research::research
7::7
targetted::targetted
rfid::rfid
difficulty::difficulty
reason::reason
put::put
legal-limit::legal-limit
computers::computers
2.24::2.24
widely-used::widely-used
major::major
clearly-defined::clearly-defined
prevent::prevent
feel::feel
number::number
feet::feet
least::least
reflectivity::reflectivity
station::station
amplifiers::amplifiers
hundred::hundred
store::store
muggers::muggers
relationship::relationship
part::part
focusing::focusing
believe::believe
convinced::convinced
observatory::observatory
ohms::ohms
procedural::procedural
kidding::kidding
beforehand::beforehand
alike::alike
paths::paths
nights::nights
built::built
majority::majority
build::build
analogy::analogy
knobs::knobs
added::added
measures::measures
most::most
plan::plan
significant::significant
70::70
nothing::nothing
measured::measured
understands::understands
mobile::mobile
clear::clear
sometimes::sometimes
cover::cover
traditional::traditional
reflections::reflections
clean::clean
naively::naively
scattered::scattered
beamwidth::beamwidth
session::session
stalker::stalker
carefully::carefully
3.5db::3.5db
find::find
costing::costing
impact::impact
writer::writer
being::being
factor::factor
8::8
his::his
an/sps-49::an/sps-49
line-of-sight::line-of-sight
remedy::remedy
grew::grew
5,000::5,000
during::during
remove::remove
common::common
x::x
achieved::achieved
still::still
317::317
see::see
defense::defense
are::are
ebay::ebay
deploying::deploying
currently::currently
degrading::degrading
various::various
probably::probably
conditions::conditions
available::available
creating::creating
missing::missing
targeted::targeted
spacing::spacing
general-purpose::general-purpose
incident::incident
distinguish::distinguish
relying::relying
both::both
50dbm::50dbm
license::license
foreign::foreign
let::let
hackers::hackers
supply::supply
simple::simple
corresponds::corresponds
simply::simply
expensive::expensive
pr::pr
described::described
pt::pt
due::due
dropping::dropping
understand::understand
stolen::stolen
look::look
tip::tip
tombom.co.uk::tombom.co.uk
technical::technical
while::while
replaced::replaced
loop::loop
larger::larger
itself::itself
commonly::commonly
reprogram::reprogram
read::read
virtually::virtually
widely::widely
modification::modification
resulting::resulting
attack::attack
first-pass::first-pass
used::used
lie::lie
usually::usually
moment::moment
levels::levels
uses::uses
lower::lower
halve::halve
person::person
synopsis::synopsis
organization::organization
cryogenic::cryogenic
powering::powering
intervals::intervals
questions::questions
world::world
$::$
also::also
signals::signals
source::source
location::location
input::input
//bit.ly/dx2pmd:://bit.ly/dx2pmd
radiator::radiator
big::big
follows::follows
signal::signal
separately::separately
popular::popular
essential::essential
mathematical::mathematical
often::often
some::some
back::back
bounce::bounce
towards::towards
curious::curious
border-crossing::border-crossing
scale::scale
pep::pep
-5dbm::-5dbm
either::either
be::be
step::step
30+::30+
plots::plots
by::by
goods::goods
consumption::consumption
anything::anything
software-radio::software-radio
preamplifier::preamplifier
range::range
block::block
12,000::12,000
into::into
within::within
watt::watt
primarily::primarily
connector::connector
chrispaget::chrispaget
extremely::extremely
long::long
considerably::considerably
inches::inches
properly::properly
two-part::two-part
line::line
transmits::transmits
up::up
us::us
're::'re
similar::similar
called::called
500ft::500ft
saturate::saturate
yagi::yagi
single::single
pre-programmed::pre-programmed
codes::codes
amounts::amounts
functionality::functionality
calculating::calculating
prepared::prepared
allowing::allowing
sides::sides
correlated::correlated
valuables::valuables
required::required
orbit::orbit
2000::2000
presenting::presenting
far::far
requires::requires
evenly::evenly
gt::gt
gr::gr
issued::issued
amplifier::amplifier
results::results
edl::edl
go::go
amplified::amplified
granular::granular
helps::helps
include::include
sent::sent
transponders::transponders
miners::miners
wishes::wishes
entire::entire
transmission::transmission
anechoic::anechoic
licensed::licensed
licenses::licenses
folk::folk
business::business
morse::morse
gen2::gen2
expressed::expressed
access::access
then::then
;::;
chose::chose
degree::degree
commercial::commercial
objects::objects
focused::focused
licence::licence
extreme::extreme
casing::casing
receive::receive
involved::involved
30::30
leaving::leaving
products::products
makes::makes
examining::examining
decrease::decrease
standing::standing
use::use
from::from
usa::usa
&::&
remains::remains
readable::readable
next::next
few::few
examination::examination
vehicle::vehicle
cram::cram
themselves::themselves
noisy::noisy
becomes::becomes
benchmark::benchmark
13dbm::13dbm
carrying::carrying
sharply::sharply
antennas::antennas
disabling::disabling
//kb0mga.net/exams/:://kb0mga.net/exams/
this::this
assumptions::assumptions
drops::drops
control::control
high::high
effectively::effectively
tag::tag
memorize::memorize
holds::holds
attachment::attachment
instead::instead
stock::stock
attend::attend
specifications::specifications
blackhat::blackhat
correspond::correspond
element::element
allow::allow
attenuator::attenuator
crosstalk::crosstalk
perfect::perfect
chosen::chosen
degrees::degrees
2010::2010
polarizations::polarizations
practice::practice
seawater::seawater
subtraction::subtraction
transparent::transparent
articles::articles
transmitter::transmitter
identified::identified
sniffing::sniffing
transmitted::transmitted
shortage::shortage
crossing::crossing
identifies::identifies
identifier::identifier
related::related
frequency::frequency
sands::sands
separating::separating
our::our
80::80
out::out
cause::cause
announced::announced
rmax::rmax
70w::70w
approaches::approaches
300-meter::300-meter
g::g
could::could
times::times
isotropic::isotropic
hence::hence
retail::retail
soldered::soldered
powerful::powerful
improvements::improvements
owner::owner
reached::reached
precisely::precisely
prank::prank
fair::fair
privacy::privacy
system::system
their::their
1500::1500
tourists::tourists
gear::gear
startup::startup
exactly::exactly
diminish::diminish
milliwatt::milliwatt
limiting::limiting
providing::providing
have::have
need::need
border::border
clearly::clearly
documents::documents
able::able
mechanism::mechanism
gen2based::gen2based
which::which
=::=
high-valued::high-valued
worldwide::worldwide
unless::unless
who::who
connected::connected
30dbm::30dbm
device::device
500+::500+
class::class
so-called::so-called
30db::30db
consequences::consequences
gather::gather
stronger::stronger
6dbm::6dbm
6dbi::6dbi
fact::fact
dbi::dbi
atmosphere::atmosphere
selection::selection
dbm::dbm
supported::supported
rotating::rotating
high-level::high-level
trivial::trivial
based::based
knowledge::knowledge
hops::hops
catalogue::catalogue
should::should
employed::employed
achieve::achieve
im-me::im-me
cube::cube
handle::handle
means::means
==::==
overall::overall
beam::beam
words::words
timing::timing
applying::applying
gen2-compliant::gen2-compliant
areas::areas
tuned::tuned
generations::generations
knowing::knowing
halving::halving
operates::operates
travis::travis
intensity::intensity
enhanced::enhanced
operated::operated
wire::wire
record::record
tend::tend
initially::initially
state::state
identification::identification
correctly::correctly
bought::bought
decibels::decibels
ability::ability
emitted::emitted
interfere::interfere
efficiency::efficiency
//bit.ly/bknok:://bit.ly/bknok
configuration::configuration
restrictions::restrictions
sniff::sniff
limits::limits
freely::freely
taking::taking
aircraft::aircraft
assure::assure
18db::18db
walk::walk
provinces::provinces
powered::powered
addition::addition
epcglobal::epcglobal
define::define
corresponding::corresponding
route::route
sufficient::sufficient
bulk::bulk
confers::confers
an::an
present::present
homes::homes
atmospheric::atmospheric
unlike::unlike
as::as
value::value
will::will
almost::almost
demo::demo
surface::surface
malls::malls
terrorist::terrorist
privileges::privileges
parts::parts
largest::largest
units::units
terrorism::terrorism
http::http
absorb::absorb
upon::upon
effect::effect
identity::identity
off::off
reflection::reflection
i::i
well::well
10-mile::10-mile
position::position
/2::/2
stores::stores
less::less
increasingly::increasingly
obtain::obtain
distant::distant
point::point
capabilities::capabilities
day::day
add::add
combine::combine
280::280
match::match
tests::tests
increased::increased
increases::increases
know::know
deployment::deployment
variants::variants
loss::loss
necessary::necessary
like::like
lost::lost
sizes::sizes
sized::sized
become::become
works::works
page::page
amendment::amendment
10db::10db
because::because
preamp::preamp
choosing::choosing
home::home
neglecting::neglecting
preamplifiers::preamplifiers
does::does
assuming::assuming
chains::chains
?::?
noise::noise
acronym::acronym
real-world::real-world
expiry::expiry
stage::stage
about::about
rare::rare
13dbi::13dbi
shipping::shipping
compatible::compatible
carries::carries
carrier::carrier
on-stage::on-stage
discard::discard
software::software
equally::equally
mere::mere
additional::additional
transfer::transfer
noticed::noticed
notices::notices
function::function
565::565
but::but
volume::volume
gain::gain
automated::automated
technician::technician
hf::hf
he::he
made::made
whether::whether
dangerous::dangerous
placed::placed
below::below
limit::limit
4dbm::4dbm
problem::problem
minutes::minutes
mechanics::mechanics
ionosphere::ionosphere
lobes::lobes
identities::identities
compared::compared
'll::'ll
nonetheless::nonetheless
corporation::corporation
detail::detail
non-existant::non-existant
other::other
details::details
18.5+7::18.5+7
stag::stag
coupling::coupling
using::using
factors::factors
high-value::high-value
