::
magnetically::magnetically
all::all
consider::consider
upper-right::upper-right
represent::represent
control::control
foveated::foveated
global::global
dynamic::dynamic
results::results
illustrated::illustrated
obstruction::obstruction
scalar::scalar
consists::consists
fusing::fusing
nishiyama::nishiyama
unobstructed::unobstructed
row::row
//www.epcglobalus.org/:://www.epcglobalus.org/
number::number
kleiner::kleiner
iii::iii
thingmagic::thingmagic
interactions::interactions
environment::environment
to::to
finally::finally
those::those
marks::marks
cluttered::cluttered
analogous::analogous
must::must
screen::screen
worth::worth
indicating::indicating
case::case
attempts::attempts
labels::labels
straightforward::straightforward
returning::returning
very::very
account::account
omnidirectional::omnidirectional
icam::icam
handling::handling
affect::affect
tagging::tagging
elated::elated
differentiated::differentiated
clouds::clouds
short-range::short-range
presented::presented
::
positions::positions
metadata::metadata
correct::correct
large::large
beamwidths::beamwidths
independence::independence
mizuta::mizuta
informative::informative
perceptual::perceptual
flash::flash
limitations::limitations
kubitz::kubitz
employing::employing
version::version
selfadhesive::selfadhesive
estimates::estimates
discover::discover
d::d
rate::rate
cost::cost
design::design
6dof::6dof
pass::pass
further::further
6.5dbi::6.5dbi
estimated::estimated
ptag|f0::ptag|f0
will::will
person/object::person/object
power::power
argmaxx::argmaxx
10-14::10-14
94.4::94.4
+::+
selected::selected
near::near
uniform::uniform
current::current
transmit::transmit
issues::issues
above::above
pcolor|tag::pcolor|tag
new::new
;::;
method::method
contrast::contrast
3d::3d
body::body
deemed::deemed
centric::centric
chose::chose
tags::tags
respectively::respectively
human::human
even::even
component::component
here::here
ranges::ranges
desired::desired
objects::objects
active::active
pp3d::pp3d
100::100
strong::strong
105::105
obtained::obtained
sensory::sensory
great::great
rfid-enabled::rfid-enabled
receive::receive
k::k
vectors::vectors
allows::allows
transponder::transponder
commonly::commonly
example::example
prior::prior
resulting::resulting
menu::menu
action::action
ota::ota
devices::devices
navigation::navigation
pp::pp
bayes::bayes
|tag::|tag
::
via::via
digitally::digitally
projection::projection
vii::vii
marked::marked
gharpure::gharpure
scaled::scaled
visible::visible
visualization::visualization
motor::motor
apply::apply
total::total
sensors::sensors
select::select
remaining::remaining
obile::obile
use::use
usd::usd
from::from
takes::takes
usa::usa
0::0
distinct::distinct
reynolds2::reynolds2
two::two
properties::properties
scenarios::scenarios
depicted::depicted
camera::camera
overhead::overhead
6::6
ieee/rsj::ieee/rsj
selects::selects
more::more
flat::flat
joho::joho
pfi::pfi
126130::126130
factor::factor
constructs::constructs
half-power::half-power
actuated::actuated
nguyen::nguyen
tested::tested
visual::visual
8::8
varying::varying
antennas::antennas
cases::cases
mounted::mounted
producing::producing
potential::potential
insights::insights
keeping::keeping
1997::1997
f::f
this::this
ml::ml
uture::uture
work::work
accumulated::accumulated
alone::alone
sept.-2::sept.-2
assumptions::assumptions
values::values
can::can
post-grasp::post-grasp
v::v
mages::mages
rssi::rssi
metal::metal
4588::4588
object-specific::object-specific
hagita::hagita
performed::performed
f0::f0
challenging::challenging
figure::figure
scan::scan
process::process
0.0::0.0
segon::segon
indicates::indicates
nicholson::nicholson
tag::tag
segmentations::segmentations
montage::montage
coincident::coincident
sense::sense
handle::handle
standard::standard
transactions::transactions
reynolds::reynolds
4613::4613
absolute::absolute
information::information
end::end
advantage::advantage
provide::provide
tilt::tilt
meanwhile::meanwhile
feature::feature
1::1
how::how
numerous::numerous
assistive::assistive
intelligent::intelligent
panned::panned
classify::classify
inputs::inputs
tag-based::tag-based
incorporated::incorporated
capture::capture
may::may
after::after
derived::derived
mapping::mapping
lab::lab
perceive::perceive
applications::applications
machine::machine
produce::produce
opening::opening
water::water
date::date
such::such
cuschcraft::cuschcraft
choice::choice
data::data
fn::fn
efficiently::efficiently
a::a
ambiguous::ambiguous
marginalize::marginalize
attempt::attempt
modeled::modeled
effective::effective
long-range::long-range
light::light
goal::goal
register::register
robot::robot
parameterized::parameterized
q::q
inform::inform
complexity::complexity
so::so
jain::jain
healthcare::healthcare
representation::representation
no-read::no-read
inte::inte
tagged::tagged
least::least
help::help
produces::produces
developed::developed
over::over
vary::vary
recently-developed::recently-developed
kemp1::kemp1
produced::produced
saturates::saturates
including::including
interpolation::interpolation
filters::filters
unfavorable::unfavorable
ntroduction::ntroduction
multipath::multipath
avenue::avenue
its::its
scale::scale
regions::regions
26::26
april-1::april-1
fit::fit
located::located
chosen::chosen
interesting::interesting
rfid-based::rfid-based
28::28
waypoint::waypoint
forms::forms
estimating::estimating
absence::absence
production::production
compelling::compelling
fig::fig
what::what
orange::orange
potentially::potentially
customized::customized
pixel::pixel
kemp::kemp
uhf::uhf
then::then
them::them
ground-truth::ground-truth
entire::entire
propose::propose
ensor::ensor
introduce::introduce
scene::scene
9::9
mitigated::mitigated
pp3d|tag::pp3d|tag
they::they
shiomi::shiomi
not::not
employed::employed
rfid-tagged::rfid-tagged
860mhz-960mhz::860mhz-960mhz
represents::represents
term::term
university::university
l::l
2d::2d
transmission::transmission
mode::mode
hebert::hebert
each::each
found::found
5730::5730
higher::higher
successful::successful
tilted::tilted
determine::determine
independent::independent
generation::generation
positioned::positioned
gaussian::gaussian
related::related
640x480::640x480
frequency::frequency
expect::expect
combining::combining
our::our
operation::operation
beyond::beyond
medication::medication
special::special
out::out
maximizes::maximizes
shown::shown
lastly::lastly
network::network
factors::factors
posteriors::posteriors
philipose::philipose
cameras::cameras
interference::interference
research::research
transforming::transforming
rf::rf
47th::47th
7::7
reader::reader
squares::squares
sensor::sensor
integrated::integrated
red::red
cabinet::cabinet
perception::perception
umbrella::umbrella
linear::linear
localization::localization
easily::easily
hirai::hirai
fiducials::fiducials
lead::lead
approaches::approaches
pantilt::pantilt
advantages::advantages
ork::ork
x::x
roh::roh
intermediate::intermediate
estimate::estimate
automation::automation
likelihood::likelihood
training::training
interaction::interaction
ueyama::ueyama
g::g
e.g::e.g
locations::locations
could::could
computers::computers
21::21
halting::halting
creates::creates
turn::turn
conducted::conducted
explored::explored
due::due
w::w
qn::qn
facilitate::facilitate
support::support
drink::drink
first::first
ieee::ieee
ability::ability
placing::placing
fetched::fetched
features::features
probability::probability
primary::primary
contributions::contributions
one::one
instances::instances
fetches::fetches
adopted::adopted
another::another
enumerate::enumerate
array::array
ystem::ystem
user-selected::user-selected
horizontal::horizontal
xu::xu
mercury::mercury
given::given
test::test
top::top
histograms::histograms
system::system
construct::construct
their::their
returns::returns
2::2
rates::rates
observations::observations
composing::composing
vehicular::vehicular
white::white
bits::bits
ranging::ranging
plagemann::plagemann
scans::scans
1999::1999
inferring::inferring
tagindexed::tagindexed
servo::servo
that::that
johnson::johnson
completed::completed
self-adhesive::self-adhesive
direct::direct
environmental::environmental
rectified::rectified
optical::optical
manipulation::manipulation
13791384::13791384
believe::believe
chong::chong
than::than
reflection::reflection
11::11
detection::detection
13::13
12::12
15::15
target::target
17::17
1m::1m
18::18
pointers::pointers
database::database
see::see
limiting::limiting
recording::recording
r::r
187192::187192
were::were
video::video
toward::toward
treated::treated
displays::displays
behaviors::behaviors
ohba::ohba
fashion::fashion
1.0::1.0
battery-free::battery-free
dynamically::dynamically
waypoints::waypoints
glass::glass
correspond::correspond
raw::raw
slam::slam
manner::manner
have::have
need::need
null::null
modality::modality
relatively::relatively
robot-assisted::robot-assisted
strength::strength
angle::angle
depending::depending
efficient::efficient
ziparo::ziparo
latter::latter
iros::iros
able::able
imitations::imitations
oriented::oriented
also::also
fitting::fitting
without::without
which::which
online::online
indexed::indexed
performance::performance
=::=
evaluated::evaluated
accuracy::accuracy
blue::blue
ishiguro::ishiguro
acquire::acquire
multiple::multiple
inference::inference
though::though
83.3::83.3
object::object
systems::systems
most::most
overlapping::overlapping
significant::significant
70::70
pair::pair
future::future
measured::measured
model::model
workshop::workshop
lee::lee
placement::placement
advantageous::advantageous
failure::failure
mobile::mobile
into::into
m::m
repeated::repeated
order::order
proceedings::proceedings
points::points
azimuth::azimuth
typically::typically
section::section
fitted::fitted
science::science
incorporate::incorporate
selection::selection
dbm::dbm
show::show
charles::charles
1.0.9::1.0.9
kito::kito
rotating::rotating
purely::purely
beamwidth::beamwidth
executed::executed
radio::radio
anipulation::anipulation
find::find
xml::xml
indicator::indicator
circularly::circularly
based::based
choi::choi
parameters::parameters
wooden::wooden
implementation::implementation
true::true
april::april
distributed::distributed
behind::behind
only::only
explicitly::explicitly
captures::captures
enumerated::enumerated
smoothed::smoothed
b::b
yml::yml
achieve::achieve
equilibrium::equilibrium
do::do
dominant::dominant
wide::wide
cushcraft::cushcraft
tilting::tilting
el-e::el-e
p::p
among::among
line-of-sight::line-of-sight
polarized::polarized
international::international
128::128
during::during
14::14
acm::acm
qr::qr
indicated::indicated
bearings::bearings
deyle::deyle
16::16
teams::teams
yield::yield
patch::patch
twice::twice
experiments::experiments
convolve::convolve
accomplish::accomplish
mapped::mapped
through::through
fixed::fixed
where::where
valid::valid
vision::vision
view::view
scanning::scanning
set::set
10151020::10151020
proximal::proximal
reference::reference
achieved::achieved
argmax::argmax
intelligence::intelligence
frame::frame
comparable::comparable
blurred::blurred
relative::relative
travis::travis
intensity::intensity
computer::computer
geometrically::geometrically
are::are
localize::localize
pimage::pimage
discriminating::discriminating
observed::observed
battery::battery
techniques::techniques
surfaces::surfaces
instance::instance
detect::detect
mechanically::mechanically
tanie::tanie
registering::registering
placed::placed
ways::ways
pattern::pattern
currently::currently
behavior-based::behavior-based
tamura::tamura
tend::tend
3::3
determined::determined
identification::identification
correctly::correctly
between::between
graphically::graphically
reading::reading
approach::approach
across::across
discovery::discovery
available::available
we::we
various::various
terms::terms
responses::responses
vertical::vertical
complementary::complementary
disposable::disposable
filter::filter
sole::sole
however::however
york::york
concentrate::concentrate
interface::interface
modeling::modeling
distribution::distribution
improve::improve
both::both
c::c
improved::improved
orients::orients
reported::reported
successes::successes
many::many
uncertainty::uncertainty
previously::previously
perlick::perlick
propagation::propagation
s::s
context::context
contribution::contribution
estimation::estimation
humanoid::humanoid
experimental::experimental
otherwise::otherwise
and::and
fi::fi
filtering::filtering
ptag::ptag
fields::fields
point::point
simple::simple
robotics::robotics
corresponds::corresponds
environments::environments
2nd::2nd
60::60
invisible::invisible
visually::visually
rfid-enhanced::rfid-enhanced
framerates::framerates
false::false
along::along
expensive::expensive
servoing::servoing
conference::conference
signals::signals
ensures::ensures
id-specific::id-specific
fused::fused
perspectives::perspectives
powered::powered
addition::addition
trajectory::trajectory
create::create
three::three
been::been
pixels::pixels
int::int
much::much
combined::combined
interest::interest
basic::basic
902-928mhz::902-928mhz
combine::combine
gaussian-filtered::gaussian-filtered
location::location
box::box
direction::direction
enable::enable
corresponding::corresponding
received::received
influence::influence
precision::precision
affixed::affixed
readings::readings
drawer::drawer
photos::photos
rangefinder::rangefinder
0.10::0.10
angles::angles
spin::spin
present::present
applied::applied
georgia::georgia
laser::laser
exponential::exponential
4-7::4-7
these::these
permit::permit
as::as
value::value
n::n
employ::employ
institute::institute
while::while
usion::usion
smart::smart
evaluating::evaluating
aid::aid
2007::2007
at::at
nebel::nebel
versus::versus
prssi|tag::prssi|tag
orientation::orientation
coupled::coupled
vol::vol
characteristics::characteristics
is::is
thus::thus
it::it
katsuki::katsuki
iv::iv
ii::ii
reads::reads
itself::itself
reports::reports
conf::conf
in::in
primitives::primitives
aspects::aspects
technology::technology
id::id
if::if
result::result
binary::binary
rangefinders::rangefinders
polar::polar
verified::verified
confirming::confirming
interactive::interactive
trial::trial
fetching::fetching
make::make
secondorder::secondorder
radiation::radiation
11.1::11.1
same::same
any::any
highlighted::highlighted
4593::4593
complex::complex
nguyen1::nguyen1
grated::grated
widely::widely
advances::advances
panning::panning
helpers::helpers
several::several
showing::showing
pan::pan
difficult::difficult
odometry::odometry
used::used
http::http
i0::i0
rfid::rfid
hand::hand
effectively::effectively
fuse::fuse
uses::uses
user::user
kim::kim
robotic::robotic
single::single
recent::recent
nardi::nardi
task::task
maximizing::maximizing
scenario::scenario
framework::framework
i::i
servos::servos
no::no
well::well
roughly::roughly
analysis::analysis
calibrated::calibrated
5725::5725
bottle::bottle
sets::sets
y::y
position::position
the::the
nearby::nearby
sensing::sensing
epc::epc
left::left
ny::ny
hongu::hongu
pf0::pf0
protocol::protocol
background::background
less::less
being::being
when::when
accurate::accurate
docking::docking
rotated::rotated
obtain::obtain
valuable::valuable
overcoming::overcoming
effector::effector
front::front
stored::stored
identify::identify
correspondences::correspondences
world::world
touch::touch
spatially::spatially
alternative::alternative
rotates::rotates
finger-mounted::finger-mounted
previous::previous
hai::hai
volumetric::volumetric
landmarking::landmarking
$::$
candidate::candidate
extracted::extracted
absorption::absorption
had::had
eferences::eferences
capabilities::capabilities
improvement::improvement
passive::passive
color::color
interested::interested
transformed::transformed
4::4
knowledge::knowledge
modalities::modalities
5e::5e
5::5
rssiraw::rssiraw
has::has
transformation::transformation
finder::finder
real::real
tests::tests
elevation::elevation
impaired::impaired
format::format
read::read
evaluate::evaluate
capacities::capacities
measurement::measurement
oct::oct
finding::finding
fusion::fusion
130135::130135
irange::irange
interfaces::interfaces
using::using
305312::305312
unique::unique
dumoulin::dumoulin
occurring::occurring
articulated::articulated
success::success
particle::particle
88.9::88.9
follows::follows
signal::signal
identifying::identifying
maximum-likelihood::maximum-likelihood
arrays::arrays
indication::indication
either::either
1k-bit::1k-bit
output::output
works::works
occlusion::occlusion
names::names
right::right
methods::methods
deal::deal
people::people
belonged::belonged
successfully::successfully
some::some
back::back
p3d::p3d
37113716::37113716
strongest::strongest
meters::meters
examples::examples
images::images
affixing::affixing
berger::berger
recognition::recognition
manipulator::manipulator
recently::recently
for::for
confirm::confirm
demonstrates::demonstrates
measurements::measurements
fox::fox
exceeding::exceeding
/::/
hand-labeled::hand-labeled
conditionally::conditionally
quickly::quickly
critical::critical
linearly::linearly
assuming::assuming
steps::steps
confusion::confusion
esults::esults
t::t
measuring::measuring
be::be
particular::particular
pan/tilt::pan/tilt
deyle1::deyle1
kulyukin::kulyukin
selecting::selecting
pose::pose
conventional::conventional
robots::robots
occurred::occurred
become::become
described::described
by::by
discriminative::discriminative
i=1::i=1
on::on
identifier::identifier
would::would
far-field::far-field
of::of
capable::capable
ids::ids
o::o
trevor::trevor
probabilities::probabilities
range::range
accessibility::accessibility
introduced::introduced
or::or
software::software
vi::vi
duke::duke
rss::rss
presence::presence
low-cost::low-cost
communication::communication
image::image
within::within
integral::integral
irssi::irssi
dataset::dataset
pavithran::pavithran
primarily::primarily
registration::registration
approximately::approximately
retrieve::retrieve
refined::refined
next::next
descriptive::descriptive
often::often
performing::performing
additional::additional
area::area
probabilistic::probabilistic
museum::museum
there::there
transform::transform
long::long
lidar::lidar
indoor::indoor
occupy::occupy
anderson::anderson
noting::noting
low::low
h::h
resulted::resulted
subsequent::subsequent
was::was
materials::materials
etc::etc
function::function
considerably::considerably
viii::viii
form::form
attempted::attempted
registered::registered
s9028pc::s9028pc
but::but
histogram::histogram
volume::volume
collected::collected
cloud::cloud
incorporation::incorporation
gain::gain
automated::automated
4606::4606
e::e
human-robot::human-robot
with::with
made::made
distractor::distractor
intuitive::intuitive
non-object::non-object
whether::whether
inside::inside
j::j
robustness::robustness
maximum::maximum
us::us
different::different
considered::considered
note::note
exploration::exploration
objectspecific::objectspecific
grasp::grasp
demonstrate::demonstrate
autonomous::autonomous
z::z
called::called
distance::distance
onclusions::onclusions
bearing::bearing
units::units
associated::associated
scanner::scanner
defined::defined
co-located::co-located
abstract::abstract
describe::describe
moved::moved
graphical::graphical
deep::deep
an::an
engineering::engineering
scanned::scanned
arai::arai
grasped::grasped
field::field
19791984::19791984
door::door
plan::plan
distributions::distributions
proceeds::proceeds
incorrect::incorrect
again::again
burgard::burgard
codes::codes
%::%
tag-centric::tag-centric
antenna::antenna
variety::variety
vol.1::vol.1
trials::trials
45::45
storage::storage
reality::reality
selected-tag::selected-tag
application::application
other::other
electrical::electrical
spatial::spatial
department::department
hahnel::hahnel
10::10
deviation::deviation
requested::requested
grasps::grasps
kanda::kanda
users::users
models::models
sigchi/sigart::sigchi/sigart
class::class
mechanical::mechanical
matt::matt
variation::variation
includes::includes
generated::generated
slice::slice
peak::peak
additionally::additionally
fishkin::fishkin
sigaccess::sigaccess
yields::yields
433449::433449
2009::2009
remote::remote
faster::faster
algorithm::algorithm
scenes::scenes
assume::assume
bottom::bottom
mask::mask
rule::rule
battery-powered::battery-powered
2003::2003
beverage::beverage
2006::2006
presenting::presenting
2004::2004
simplicity::simplicity
far::far
failures::failures
2008::2008
augmented::augmented
resolution::resolution
near-field::near-field
