::
neighbors::neighbors
all::all
childs::childs
todays::todays
lack::lack
vldb::vldb
results::results
existing::existing
four::four
consists::consists
denotes::denotes
revealed::revealed
assembled::assembled
improperly::improperly
relationships::relationships
graph::graph
concerned::concerned
technique::technique
created::created
presents::presents
to::to
shenoy::shenoy
stable::stable
nodes::nodes
indicating::indicating
@::@
updated::updated
confirmation::confirmation
takes::takes
very::very
role::role
focus::focus
novel::novel
every::every
updates::updates
check::check
adaptive::adaptive
timely::timely
mostlikely::mostlikely
exits::exits
level::level
roblem::roblem
attempts::attempts
standards::standards
p::p
edakkunni::edakkunni
rk::rk
foundation::foundation
nterpretation::nterpretation
consistent::consistent
estimates::estimates
past::past
likely::likely
design::design
incrementally::incrementally
further::further
dynamics::dynamics
implemented::implemented
even::even
diao::diao
what::what
richard::richard
section::section
spire::spire
4::4
current::current
version::version
above::above
new::new
;::;
acknowledgments::acknowledgments
synthetic::synthetic
outgoing::outgoing
simultaneously::simultaneously
chose::chose
v::v
modify::modify
here::here
reported::reported
objects::objects
compressed::compressed
address::address
represented::represented
i.e::i.e
100::100
fan-in::fan-in
change::change
obtained::obtained
incoming::incoming
colored::colored
warehousing::warehousing
items::items
k::k
changed::changed
reports::reports
prior::prior
throughput::throughput
franklin::franklin
shaded::shaded
changes::changes
exited::exited
tasks::tasks
useful::useful
addresses::addresses
triplet::triplet
transit::transit
logical::logical
incorporates::incorporates
analyzing::analyzing
amherst::amherst
total::total
a,1::a,1
environment::environment
use::use
from::from
figure::figure
&::&
positive::positive
contains::contains
two::two
next::next
depicted::depicted
opposed::opposed
6::6
type::type
entails::entails
more::more
extent::extent
weight::weight
definition::definition
outputs::outputs
under::under
guarantees::guarantees
8::8
particular::particular
known::known
90::90
cases::cases
mounted::mounted
iii::iii
capturing::capturing
fly::fly
co-location::co-location
account::account
f::f
this::this
science::science
challenge::challenge
work::work
remain::remain
values::values
can::can
containment::containment
arrive::arrive
example::example
history::history
stream::stream
scan::scan
preserving::preserving
high::high
tag::tag
employs::employs
conversely::conversely
per-tag::per-tag
pre-defined::pre-defined
information::information
needs::needs
monitoring::monitoring
provide::provide
technology::technology
divided::divided
feature::feature
stayed::stayed
occur::occur
1::1
far::far
adjacent::adjacent
massive::massive
mar::mar
may::may
designated::designated
after::after
confirmed::confirmed
applications::applications
designed::designed
such::such
data::data
a::a
ambiguous::ambiguous
remember::remember
sets::sets
whenever::whenever
redundant::redundant
or::or
so::so
allow::allow
balancing::balancing
subsequently::subsequently
operations::operations
garofalakis::garofalakis
interpretation::interpretation
produces::produces
over::over
move::move
installed::installed
produced::produced
paper::paper
including::including
coarsely::coarsely
statistical::statistical
still::still
its::its
before::before
formraises::formraises
thanh::thanh
chosen::chosen
temporal::temporal
lk::lk
coordinates::coordinates
b,2::b,2
absence::absence
distinguishing::distinguishing
fig::fig
fade::fade
ompression::ompression
defining::defining
<::<
then::then
them::them
good::good
timestamp::timestamp
100,000::100,000
scaling::scaling
dock::dock
prashant::prashant
ummary::ummary
not::not
now::now
maintaining::maintaining
easily::easily
university::university
tran::tran
arrows::arrows
l::l
events::events
possibilities::possibilities
applied::applied
each::each
linked::linked
individually::individually
domain::domain
significantly::significantly
co-located::co-located
idea::idea
challenges::challenges
connect::connect
our::our
80::80
event::event
special::special
gonzalez::gonzalez
shown::shown
container::container
missed::missed
discrete::discrete
furthermore::furthermore
since::since
research::research
content::content
contained::contained
imperative::imperative
7::7
reader::reader
denoted::denoted
erformance::erformance
common::common
co-locations::co-locations
maintains::maintains
x::x
estimate::estimate
generate::generate
additional::additional
aisle::aisle
hardware::hardware
workloads::workloads
g::g
e.g::e.g
determining::determining
inferred::inferred
positioning::positioning
hong::hong
edges::edges
due::due
w::w
hence::hence
retain::retain
first::first
intuition::intuition
real-time::real-time
ntroduction::ntroduction
probability::probability
encoding::encoding
containments::containments
number::number
transform::transform
least::least
reached::reached
three-way::three-way
electronic::electronic
given::given
impairing::impairing
indicate::indicate
unknown::unknown
system::system
construct::construct
apture::apture
their::their
2::2
rates::rates
observations::observations
c,2::c,2
c,3::c,3
summarization::summarization
relationship::relationship
that::that
shelf::shelf
relative::relative
exactly::exactly
t=1::t=1
t=2::t=2
t=3::t=3
contruction::contruction
representing::representing
than::than
11::11
10::10
b::b
prune::prune
uncolored::uncolored
double::double
rate::rate
individual::individual
represents::represents
enables::enables
result::result
and::and
false::false
remained::remained
locations::locations
raw::raw
have::have
icde::icde
need::need
seen::seen
any::any
reiss::reiss
efficient::efficient
able::able
note::note
also::also
potential::potential
which::which
=::=
channel::channel
accuracy::accuracy
blue::blue
play::play
added::added
multiple::multiple
object::object
systems::systems
most::most
said::said
connected::connected
encodes::encodes
significant::significant
retaining::retaining
probabilistic::probabilistic
the::the
stream-driven::stream-driven
observation::observation
locationsa::locationsa
mobile::mobile
neighboring::neighboring
dataa::dataa
time-varying::time-varying
graphs::graphs
part::part
enterprise::enterprise
notion::notion
fact::fact
show::show
v10::v10
supported::supported
colors::colors
epochs::epochs
one::one
highest::highest
based::based
knowledge::knowledge
true::true
less::less
3::3
deployments::deployments
only::only
inherited::inherited
employed::employed
cocci::cocci
epcglobal::epcglobal
count::count
utput::utput
means::means
dependent::dependent
db::db
hifi::hifi
h::h
despite::despite
combinations::combinations
compute::compute
becomes::becomes
areas::areas
substrate::substrate
initial::initial
cns-052072::cns-052072
approach::approach
comprising::comprising
architecture::architecture
contain::contain
through::through
fixed::fixed
where::where
view::view
supply-chain::supply-chain
set::set
exists::exists
overwhelm::overwhelm
national::national
module::module
observed::observed
collectively::collectively
computes::computes
computer::computer
are::are
close::close
emulating::emulating
techniques::techniques
enumerates::enumerates
subsequent::subsequent
currently::currently
state::state
future::future
identification::identification
correctly::correctly
between::between
propagated::propagated
reading::reading
numerous::numerous
across::across
arrival::arrival
we::we
infrastructure::infrastructure
creating::creating
parent::parent
missing::missing
arises::arises
however::however
efficiency::efficiency
loading::loading
ttran::ttran
stationaryresident::stationaryresident
configuration::configuration
distribution::distribution
both::both
c::c
instant::instant
collocations::collocations
many::many
according::according
against::against
sensitive::sensitive
s::s
streams::streams
safely::safely
rcocci::rcocci
key::key
layers::layers
color::color
continuation::continuation
excess::excess
period::period
environments::environments
packaging::packaging
pruned::pruned
b,3::b,3
li::li
expensive::expensive
belt::belt
ensures::ensures
conveyor::conveyor
addition::addition
warehouses::warehouses
1.3::1.3
tream::tream
three::three
been::been
reduction::reduction
describes::describes
basic::basic
collocation::collocation
containers::containers
>::>
unobserved::unobserved
enable::enable
corresponding::corresponding
0002::0002
observable::observable
various::various
readings::readings
observe::observe
child::child
last::last
evidence::evidence
present::present
case::case
exception::exception
stolen::stolen
uncertain::uncertain
these::these
appearance::appearance
single::single
evaluated::evaluated
n::n
will::will
voluminous::voluminous
while::while
synchronized::synchronized
unshaded::unshaded
unreported::unreported
promising::promising
procedure::procedure
layer::layer
resident::resident
vi::vi
is::is
thus::thus
it::it
probabilistically::probabilistically
iv::iv
ii::ii
in::in
yanlei::yanlei
id::id
disappear::disappear
if::if
capture::capture
different::different
grant::grant
perhaps::perhaps
timeonly::timeonly
same::same
cs.umass.edu::cs.umass.edu
epoch::epoch
complex::complex
geographical::geographical
9::9
filtered::filtered
constructed::constructed
infer::infer
higher::higher
conflicting::conflicting
used::used
http::http
assigns::assigns
valuation::valuation
rfid::rfid
m::m
levels::levels
cleaning::cleaning
v6::v6
recent::recent
rfid-tagged::rfid-tagged
tracking::tracking
off::off
scenario::scenario
framework::framework
i::i
bit-vector::bit-vector
vertices::vertices
edge::edge
alleviate::alleviate
simulated::simulated
y::y
model::model
exploits::exploits
proposed::proposed
among::among
being::being
captures::captures
accurate::accurate
obtain::obtain
assigned::assigned
arriving::arriving
identify::identify
transforms::transforms
using::using
augments::augments
inference::inference
speed::speed
yet::yet
captured::captured
previous::previous
enters::enters
290304::290304
han::han
readers::readers
wei::wei
eferences::eferences
improvement::improvement
pallet::pallet
setting::setting
location::location
technological::technological
input::input
has::has
merely::merely
format::format
read::read
advances::advances
possible::possible
department::department
makes::makes
deployment::deployment
world::world
bit::bit
loss::loss
sorting::sorting
d::d
alternatively::alternatively
unnecessary::unnecessary
discarded::discarded
informative::informative
yields::yields
t::t
output::output
works::works
stationary::stationary
reduced::reduced
often::often
sequence::sequence
reveals::reveals
some::some
certain::certain
examples::examples
jeffery::jeffery
separately::separately
cooper::cooper
for::for
confirm::confirm
demonstrates::demonstrates
does::does
pei::pei
considerations::considerations
assuming::assuming
steps::steps
esults::esults
either::either
be::be
inaccurate::inaccurate
processing::processing
pp::pp
overall::overall
step::step
prohibited::prohibited
r::r
by::by
noisy::noisy
tatement::tatement
on::on
about::about
actual::actual
oj::oj
oi::oi
simplify::simplify
of::of
certainty::certainty
capable::capable
ids::ids
o::o
important::important
processed::processed
insufficient::insufficient
processor::processor
seeing::seeing
previously::previously
into::into
negative::negative
promise::promise
reducing::reducing
methods::methods
behind::behind
statistics::statistics
van::van
compression::compression
area::area
there::there
approximate::approximate
specifically::specifically
smoothing::smoothing
was::was
inter-object::inter-object
rizvi::rizvi
memory::memory
but::but
volume::volume
construction::construction
encoded::encoded
cidr::cidr
removed::removed
with::with
infers::infers
directed::directed
arranged::arranged
builds::builds
whether::whether
characteristic::characteristic
j::j
devices::devices
record::record
below::below
those::those
problem::problem
z::z
called::called
ordered::ordered
item::item
inadequate::inadequate
abstract::abstract
covers::covers
an::an
as::as
scanned::scanned
exist::exist
at::at
83::83
proceeds::proceeds
physical::physical
again::again
compared::compared
%::%
no::no
dashed::dashed
when::when
v3::v3
other::other
5::5
spatial::spatial
warehouse::warehouse
shows::shows
node::node
krishnamurthy::krishnamurthy
regardless::regardless
2005::2005
update::update
inherently::inherently
includes::includes
helping::helping
generated::generated
fell::fell
massachusetts::massachusetts
additionally::additionally
included::included
klabjan::klabjan
disk-based::disk-based
163174::163174
structure::structure
network::network
building::building
//www.epcglobalinc.org/:://www.epcglobalinc.org/
e::e
algorithm::algorithm
assume::assume
locationand::locationand
tradeoff::tradeoff
departs::departs
2006::2006
incomplete::incomplete
volumes::volumes
time::time
high-value::high-value
requires::requires
co-occurrences::co-occurrences
