::
limited::limited
desirable::desirable
resource/tag::resource/tag
whose::whose
granting::granting
424452::424452
dubendorfer::dubendorfer
presents::presents
@::@
updated::updated
every::every
updates::updates
summarized::summarized
vast::vast
membank::membank
feasibility::feasibility
second::second
implemented::implemented
clinicians::clinicians
specification::specification
above::above
new::new
net::net
metadata::metadata
simultaneously::simultaneously
never::never
here::here
reported::reported
102::102
path::path
100::100
items::items
study::study
museums::museums
suitable::suitable
changes::changes
diameter::diameter
campaign::campaign
mobility::mobility
explained::explained
archaeological::archaeological
total::total
hospital::hospital
000000102::000000102
call::call
asset::asset
assessment::assessment
annotations::annotations
successful::successful
aware::aware
berlin::berlin
must::must
1991::1991
springer::springer
ma::ma
mc::mc
1999::1999
work::work
bechhofer::bechhofer
ms::ms
concepts::concepts
route::route
::
organized::organized
want::want
end::end
recovery::recovery
provide::provide
travel::travel
how::how
hop::hop
symposium::symposium
ordinary::ordinary
lan::lan
description::description
after::after
barriers::barriers
minimizes::minimizes
parallel::parallel
types::types
ramanathan::ramanathan
attempt::attempt
effective::effective
low-throughput::low-throughput
689::689
keeps::keeps
first::first
order::order
operations::operations
executed::executed
office::office
over::over
50ms::50ms
before::before
production::production
fig::fig
0000010002::0000010002
schmidt::schmidt
easier::easier
then::then
them::them
fragment::fragment
break::break
they::they
bank::bank
reasonably::reasonably
l::l
timeout::timeout
each::each
series::series
principles::principles
comprises::comprises
used::used
extract::extract
network::network
content::content
re::re
adapt::adapt
reader::reader
hogan::hogan
object/product::object/product
linear::linear
associate::associate
standard::standard
sensory::sensory
estimate::estimate
universally::universally
post-sale::post-sale
exposing::exposing
starts::starts
wordptr::wordptr
stewart::stewart
already::already
electronic::electronic
payload::payload
annotated::annotated
service::service
guinness::guinness
needed::needed
rates::rates
listed::listed
percentage::percentage
allgair::allgair
distance::distance
ns-2::ns-2
target::target
333347::333347
enabled::enabled
terminological::terminological
project::project
10th::10th
acquisition::acquisition
extracting::extracting
sees::sees
ran::ran
unicast::unicast
raw::raw
seen::seen
contents::contents
relatively::relatively
forced::forced
dbms::dbms
thoroughly::thoroughly
cope::cope
thorough::thorough
oriented::oriented
causing::causing
000000002::000000002
owl-dl1::owl-dl1
object::object
phase::phase
m::m
investments::investments
yang::yang
enterprise::enterprise
1144::1144
random::random
attempts::attempts
radio::radio
solutions::solutions
availability::availability
arpa::arpa
rich::rich
integrate::integrate
oct::oct
do::do
dl::dl
10::10
air::air
watson::watson
report::report
impractical::impractical
fields::fields
traversed::traversed
architecture::architecture
8802-11::8802-11
analytical::analytical
told::told
bustein::bustein
disaster::disaster
reference::reference
sensitivity::sensitivity
depends::depends
tell/un-tell::tell/un-tell
on-demand::on-demand
07::07
artificial::artificial
future::future
6871::6871
propagated::propagated
approach::approach
discovery::discovery
preserve::preserve
we::we
poliba.it::poliba.it
terms::terms
extend::extend
however::however
topology::topology
suggested::suggested
received::received
extracts::extracts
readers::readers
pitt::pitt
against::against
receives::receives
logic::logic
uni::uni
requests::requests
telecommunications::telecommunications
schramek::schramek
recur::recur
three::three
been::been
extraction::extraction
much::much
basic::basic
life::life
drugs::drugs
commerce::commerce
manet::manet
n::n
aim::aim
preselected::preselected
k::k
procedure::procedure
074::074
metropolitan::metropolitan
2733::2733
ip::ip
is::is
it::it
in::in
ic::ic
partition-free::partition-free
id::id
if::if
containing::containing
perform::perform
make::make
inventory::inventory
avoids::avoids
filtered::filtered
several::several
gen-2::gen-2
96-bit::96-bit
manet-based::manet-based
scenario::scenario
disseminated::disseminated
materials::materials
the::the
paradigm::paradigm
epc::epc
protocol::protocol
proposed::proposed
data-oriented::data-oriented
32::32
yet::yet
previous::previous
tuples::tuples
has::has
ijipt::ijipt
sarma::sarma
1153::1153
unique::unique
advanced::advanced
performing::performing
50::50
specific::specific
sends::sends
proportionally::proportionally
unnecessary::unnecessary
advertise::advertise
tracked::tracked
for::for
/::/
locators::locators
repository::repository
marketing::marketing
architectural::architectural
manufacturing::manufacturing
properties::properties
ansi/ieee::ansi/ieee
magazine::magazine
baader::baader
automatically::automatically
destination::destination
presence::presence
bound::bound
waits::waits
un-tell::un-tell
support::support
initial::initial
way::way
overhead::overhead
was::was
medium::medium
form::form
forming::forming
differences::differences
wireless::wireless
failure::failure
removed::removed
type::type
attached::attached
maximum::maximum
devices::devices
tell::tell
stages::stages
classic::classic
abstract::abstract
physical::physical
ni::ni
no::no
whereas::whereas
generally::generally
composite::composite
unambiguously::unambiguously
role::role
tid::tid
node::node
autonomic::autonomic
update::update
sciascio::sciascio
professional::professional
variable::variable
transfers::transfers
longer::longer
interval::interval
packets::packets
together::together
reception::reception
time::time
neighbors::neighbors
managed::managed
skip::skip
manages::manages
layers::layers
depend::depend
environment::environment
0::0
finally::finally
marks::marks
analogous::analogous
//www.w3.org/tr/owlfeatures/:://www.w3.org/tr/owlfeatures/
entries::entries
short-range::short-range
level::level
dig::dig
labels::labels
item::item
science::science
000101012::000101012
upper::upper
findings::findings
cost::cost
populating::populating
purchasers::purchasers
adds::adds
current::current
reply::reply
satisfy::satisfy
wordcount::wordcount
address::address
change::change
wait::wait
sending::sending
studied::studied
usually::usually
tasks::tasks
useful::useful
working::working
sake::sake
peri::peri
scenarios::scenarios
handles::handles
criteria::criteria
theoretical::theoretical
sharing::sharing
sessions::sessions
acceptable::acceptable
effort::effort
ibm::ibm
bits::bits
originally::originally
anti-collision::anti-collision
labeled::labeled
values::values
can::can
following::following
figure::figure
attribute::attribute
zinkhan::zinkhan
e.tinelli::e.tinelli
performed::performed
conversely::conversely
listens::listens
monitoring::monitoring
provisioning::provisioning
1::1
till::till
suen::suen
parameter::parameter
product::product
5.1::5.1
max::max
5.2::5.2
applications::applications
mac::mac
designed::designed
such::such
odically::odically
data::data
annotation::annotation
hoc::hoc
outline::outline
whenever::whenever
explicit::explicit
q::q
so::so
sl::sl
representation::representation
talk::talk
typical::typical
tagged::tagged
unacceptable::unacceptable
entity::entity
ttl::ttl
still::still
ieee::ieee
5074::5074
group::group
acknowledge::acknowledge
broadcasts::broadcasts
factual::factual
conveying::conveying
matches::matches
introduce::introduce
records::records
transmissions::transmissions
not::not
matched::matched
name::name
repositories::repositories
tell/ask::tell/ask
individually::individually
domain::domain
revised::revised
pdus::pdus
challenges::challenges
naming::naming
living::living
shown::shown
space::space
furthermore::furthermore
collisions::collisions
contained::contained
internet::internet
receiving::receiving
sensor::sensor
shows::shows
byte::byte
language::language
vision::vision
1002::1002
waited::waited
1000::1000
one::one
specifically::specifically
directly::directly
carry::carry
ons::ons
message::message
forwarding::forwarding
size::size
little::little
2::2
structures::structures
donini::donini
that::that
krss::krss
broadcast::broadcast
holder::holder
than::than
specify::specify
population::population
11::11
wide::wide
13::13
12::12
15::15
14::14
16::16
19::19
18::18
require::require
r::r
were::were
and::and
diameter=4::diameter=4
ontologys::ontologys
any::any
clung::clung
iso/iec::iso/iec
note::note
equipment::equipment
broadcasting::broadcasting
performance::performance
200::200
semantic-enhanced::semantic-enhanced
multiple::multiple
normal::normal
track::track
visitors::visitors
satisfying::satisfying
mcguinness::mcguinness
inserted::inserted
kl-one-like::kl-one-like
considered::considered
adopt::adopt
steady::steady
sale::sale
politecnico::politecnico
duplication::duplication
show::show
workshops::workshops
ratio::ratio
kb/s::kb/s
soliciting::soliciting
only::only
explicitly::explicitly
apulia::apulia
equipped::equipped
get::get
between::between
resource::resource
ad-hoc::ad-hoc
seldom::seldom
prevents::prevents
where::where
16th::16th
silently::silently
physically::physically
detect::detect
kawakita::kawakita
review::review
sites::sites
3::3
refreshed::refreshed
across::across
infrastructure::infrastructure
websphere::websphere
many::many
according::according
enabling::enabling
propagation::propagation
s::s
nearby::nearby
among::among
jitter::jitter
overview::overview
period::period
exploit::exploit
grants::grants
assertions::assertions
constant::constant
4..7::4..7
berthon::berthon
computing::computing
mark::mark
workshop::workshop
likewise::likewise
hardly::hardly
engine::engine
enable::enable
ceur::ceur
30000::30000
traversal::traversal
stems::stems
those::those
case::case
these::these
characteristics::characteristics
heidelberg::heidelberg
technology::technology
borgida::borgida
different::different
granted::granted
same::same
verifies::verifies
document::document
status::status
extended::extended
rfid::rfid
codes::codes
wired::wired
advertisement::advertisement
tracking::tracking
identifiers::identifiers
severe::severe
without::without
extensible::extensible
components::components
model::model
transmitting::transmitting
when::when
rest::rest
ch::ch
renewed::renewed
dipped::dipped
intensional::intensional
time-to-live::time-to-live
interested::interested
4::4
functionality::functionality
extensive::extensive
scheduled::scheduled
aspects::aspects
read::read
epcs::epcs
early::early
traffic::traffic
using::using
moreover::moreover
discarded::discarded
benefit::benefit
t::t
reduced::reduced
specifies::specifies
simulator::simulator
specified::specified
duration::duration
matching::matching
provided::provided
memories::memories
mistugi::mistugi
provides::provides
provider::provider
semantically::semantically
withouth::withouth
power::power
seconds::seconds
equivalent::equivalent
refers::refers
on::on
central::central
reader/wi-fi::reader/wi-fi
ack::ack
of::of
resource-constrained::resource-constrained
meaning::meaning
greatly::greatly
neighbor::neighbor
tinelli::tinelli
or::or
cambridge::cambridge
inclusion::inclusion
communication::communication
references::references
determine::determine
pre-filtered::pre-filtered
actually::actually
theoretically::theoretically
semanticenhanced::semanticenhanced
logics::logics
forwarded::forwarded
area::area
assumed::assumed
there::there
low::low
assumes::assumes
conciseness::conciseness
multi-hop::multi-hop
technologies::technologies
with::with
embedded::embedded
default::default
ontologies::ontologies
detailed::detailed
gone::gone
ad::ad
barthel::barthel
an::an
as::as
scanned::scanned
at::at
file::file
lifetime::lifetime
ouuid::ouuid
incorrect::incorrect
4.4::4.4
4.1::4.1
4.3::4.3
4.2::4.2
storage::storage
field::field
5::5
requested::requested
000010002::000010002
moller::moller
schoch::schoch
requester::requester
building::building
remote::remote
mask::mask
f.scioscia::f.scioscia
transports::transports
original::original
represent::represent
all::all
semantic::semantic
consider::consider
lack::lack
research::research
reasoning::reasoning
removal::removal
brachman::brachman
to::to
solicit::solicit
application-layer::application-layer
nodes::nodes
very::very
//www.isi.edu/nsnam:://www.isi.edu/nsnam
evaluation::evaluation
large::large
bluetooth-rfid::bluetooth-rfid
small::small
neighborhood::neighborhood
tags/s::tags/s
translating::translating
further::further
what::what
section::section
brief::brief
acknowledgments::acknowledgments
full::full
tags::tags
un-told::un-told
component::component
compressed::compressed
directions::directions
i.e::i.e
depots::depots
search::search
allows::allows
transponder::transponder
experience::experience
amount::amount
advertising::advertising
action::action
disciascio::disciascio
via::via
followed::followed
appliances::appliances
sensors::sensors
select::select
contains::contains
two::two
6::6
more::more
pairs::pairs
flag::flag
basically::basically
particular::particular
foundations::foundations
recall::recall
dl03::dl03
sent::sent
v::v
matchmaking::matchmaking
rodrigues::rodrigues
compare::compare
challenging::challenging
scan::scan
share::share
collision::collision
numbers::numbers
information::information
respective::respective
interconnect::interconnect
rather::rather
fruition::fruition
ratified::ratified
crowther::crowther
ubiquitous::ubiquitous
long::long
connectivity::connectivity
m-commerce::m-commerce
lifecycle::lifecycle
a::a
removal/addition::removal/addition
co-exist::co-exist
specifying::specifying
retrieval::retrieval
help::help
developed::developed
ijswis::ijswis
paper::paper
through::through
replies::replies
its::its
20::20
forwards::forwards
23::23
ouuids::ouuids
detected::detected
systems::systems
might::might
uhf::uhf
motivated::motivated
food::food
timestamp::timestamp
flickering2::flickering2
framework::framework
hereafter::hereafter
coping::coping
fully::fully
presented::presented
inter-reader::inter-reader
capability::capability
micro::micro
characterized::characterized
referred::referred
generation::generation
reduce::reduce
numeric::numeric
expect::expect
sketched::sketched
beyond::beyond
event::event
p::p
since::since
adhere::adhere
7::7
issue::issue
base::base
ask::ask
definition::definition
owners::owners
e.g::e.g
omit::omit
romer::romer
consequence::consequence
probability::probability
590::590
number::number
traveled::traveled
well-known::well-known
resnick::resnick
notify::notify
introduction::introduction
saint::saint
store::store
recursively::recursively
part::part
std::std
kind::kind
b::b
cyclic::cyclic
nevertheless::nevertheless
contrary::contrary
2022::2022
toward::toward
motivation::motivation
needs::needs
depending::depending
conforming::conforming
majority::majority
internal::internal
build::build
command::command
added::added
populate::populate
most::most
significant::significant
services::services
kb::kb
apposite::apposite
mobile::mobile
clear::clear
coincides::coincides
traditional::traditional
kr::kr
scioscia::scioscia
particularly::particularly
phenomenon::phenomenon
//www.epcglobalinc.org:://www.epcglobalinc.org
scattered::scattered
rtt::rtt
networks::networks
parameters::parameters
distributed::distributed
being::being
8::8
traub::traub
accurate::accurate
diffusion::diffusion
tbox::tbox
hit::hit
spurious::spurious
valuable::valuable
international::international
during::during
contextual::contextual
bytes::bytes
knowledge-based::knowledge-based
remove::remove
activity::activity
set::set
intelligence::intelligence
see::see
individual::individual
descriptions::descriptions
2000ms::2000ms
2.1::2.1
i-70125::i-70125
0000000102::0000000102
currently::currently
various::various
consecutive::consecutive
available::available
recently::recently
missing::missing
initially::initially
scalability::scalability
interface::interface
both::both
c::c
leave-enter::leave-enter
improved::improved
pdu::pdu
connection::connection
context::context
whole::whole
pda::pda
patel-schneider::patel-schneider
load::load
regulates::regulates
point::point
simple::simple
adaptation::adaptation
expensive::expensive
802.11::802.11
401456::401456
due::due
maintenance::maintenance
pe::pe
generating::generating
0002::0002
precision::precision
adaptable::adaptable
demand::demand
m.ruta::m.ruta
extracted::extracted
look::look
receive::receive
while::while
smart::smart
error::error
abox::abox
loop::loop
reads::reads
triple::triple
italy::italy
shorter::shorter
ruta::ruta
cluster-heads::cluster-heads
9::9
products::products
higher::higher
arrives::arrives
u-kbs::u-kbs
semanticbased::semanticbased
moving::moving
user::user
stack::stack
recent::recent
lower::lower
database::database
spent::spent
flags::flags
y::y
entry::entry
responsible::responsible
exploits::exploits
inference::inference
nardi::nardi
alignment::alignment
tables::tables
liu::liu
advertisements::advertisements
representational::representational
source::source
remaining::remaining
lacking::lacking
format::format
mattern::mattern
bit::bit
formal::formal
d::d
follows::follows
communications::communications
individuals::individuals
methods::methods
creation::creation
some::some
back::back
trends::trends
3.2::3.2
3.3::3.3
3.1::3.1
and/or::and/or
describing::describing
decision::decision
integration::integration
per::per
tends::tends
either::either
be::be
patient::patient
processing::processing
by::by
goods::goods
dl-based::dl-based
simulation::simulation
range::range
consequently::consequently
into::into
within::within
inventoried::inventoried
0000000002::0000000002
depicted::depicted
submit::submit
handbook::handbook
forward::forward
calvanese::calvanese
memory::memory
link::link
deployed::deployed
zhu::zhu
middleware::middleware
up::up
us::us
t.dinoia::t.dinoia
heterogeneous::heterogeneous
manets::manets
associated::associated
defined::defined
cover::cover
recommendation::recommendation
globally::globally
single::single
defines::defines
extensional::extensional
application::application
actors::actors
retract::retract
elements::elements
users::users
problems::problems
generated::generated
allowing::allowing
utterly::utterly
structure::structure
e::e
required::required
2002::2002
2003::2003
implied::implied
2006::2006
2007::2007
2004::2004
2005::2005
fresh::fresh
2008::2008
once::once
code::code
edn::edn
existing::existing
cheung::cheung
012::012
logic-based::logic-based
go::go
query::query
issues::issues
compact::compact
send::send
languages::languages
declaration/retraction::declaration/retraction
stable::stable
resources::resources
confirmation::confirmation
transponders::transponders
grid::grid
categories::categories
transmission::transmission
integrating::integrating
polling::polling
locate::locate
application-specific::application-specific
plays::plays
gen2::gen2
access::access
waiting::waiting
;::;
focuses::focuses
led::led
exchange::exchange
respectively::respectively
leveraging::leveraging
155212::155212
objects::objects
let::let
levesque::levesque
implicit::implicit
rtime::rtime
weinstein::weinstein
technical::technical
involved::involved
30::30
35::35
suggests::suggests
survey::survey
decentralized::decentralized
addresses::addresses
context-aware::context-aware
description-logic::description-logic
manage::manage
redi::redi
tools::tools
gateway::gateway
use::use
ontology::ontology
from::from
consumption::consumption
live::live
next::next
assuring::assuring
expanding::expanding
milliseconds::milliseconds
formally::formally
occurred::occurred
carrying::carrying
detects::detects
retries::retries
f::f
this::this
clients::clients
krs::krs
industrial::industrial
meet::meet
fetch::fetch
control::control
reserved::reserved
links::links
providers::providers
process::process
purposes::purposes
tag::tag
di::di
located::located
instead::instead
specifications::specifications
tied::tied
requirements::requirements
allow::allow
healthcare::healthcare
fallback::fallback
insight::insight
reconstruct::reconstruct
kbs::kbs
rfid-based::rfid-based
li::li
w.r.t::w.r.t
choose::choose
outlined::outlined
mitigated::mitigated
transparent::transparent
february::february
university::university
freshness::freshness
identified::identified
read/write::read/write
transmitted::transmitted
identifier::identifier
constraints::constraints
subset::subset
700::700
related::related
bluetooth::bluetooth
our::our
81::81
agriculture::agriculture
special::special
out::out
acknowledgment::acknowledgment
req::req
interactions::interactions
retrieved::retrieved
maintains::maintains
1984::1984
approaches::approaches
interaction::interaction
g::g
could::could
timer::timer
david::david
length::length
removing::removing
hence::hence
echo::echo
reached::reached
quality::quality
owning::owning
management::management
system::system
adopted::adopted
their::their
scans::scans
pervasive::pervasive
udp::udp
academy::academy
exactly::exactly
rfids::rfids
updating::updating
patients::patients
providing::providing
are::are
1.5::1.5
1.0::1.0
bari::bari
have::have
able::able
mechanism::mechanism
which::which
connected::connected
preliminary::preliminary
device::device
class::class
neighboring::neighboring
request::request
proceedings::proceedings
high-throughput::high-throughput
emerging::emerging
selection::selection
supported::supported
centralized::centralized
high-level::high-level
based::based
knowledge::knowledge
hops::hops
cache::cache
should::should
bases::bases
noia::noia
local::local
epcglobal::epcglobal
means::means
familiar::familiar
overall::overall
ones::ones
words::words
procedures::procedures
areas::areas
processes::processes
h::h
non-functional::non-functional
fixed::fixed
199217::199217
caches::caches
endowed::endowed
frame::frame
packet::packet
enhanced::enhanced
agricultural::agricultural
closes::closes
exploited::exploited
placed::placed
pointer::pointer
dls::dls
state::state
identification::identification
sevices::sevices
luo::luo
ability::ability
u-kb::u-kb
key::key
commands::commands
attributes::attributes
objects/products::objects/products
otherwise::otherwise
hypothesize::hypothesize
environments::environments
distinguish::distinguish
rpc::rpc
table::table
600::600
addition::addition
e..l::e..l
proposal::proposal
retransmissions::retransmissions
corresponding::corresponding
last::last
general::general
present::present
novel::novel
contexts::contexts
value::value
will::will
frameworks::frameworks
deem::deem
piscitelli::piscitelli
layer::layer
thus::thus
lightweight::lightweight
swartout::swartout
http::http
elicits::elicits
conceived::conceived
upon::upon
phy::phy
distinction::distinction
i::i
well::well
7500::7500
sets::sets
firstly::firstly
sensing::sensing
advertises::advertises
stores::stores
less::less
proximity::proximity
obtain::obtain
stored::stored
virtual::virtual
advertised::advertised
cames::cames
coordination::coordination
low-level::low-level
adv::adv
web::web
capabilities::capabilities
reasons::reasons
match::match
tests::tests
increased::increased
devised::devised
semantic-based::semantic-based
increases::increases
know::know
deployment::deployment
press::press
immediately::immediately
like::like
exploiting::exploiting
hosts::hosts
retransmit::retransmit
sequence::sequence
112::112
home::home
happens::happens
lead::lead
garrett::garrett
does::does
assuming::assuming
limitations::limitations
journal::journal
host::host
expire::expire
described::described
about::about
carried::carried
universe::universe
compatible::compatible
dependency::dependency
insufficient::insufficient
introduced::introduced
owl::owl
own::own
previously::previously
functional::functional
mere::mere
w3c::w3c
transfer::transfer
trigger::trigger
ask-type::ask-type
function::function
but::but
volume::volume
automated::automated
also::also
whether::whether
wish::wish
j::j
variations::variations
record::record
below::below
problem::problem
replying::replying
dissemination::dissemination
functions::functions
detail::detail
40::40
other::other
details::details
conclusion::conclusion
u-commerce::u-commerce
starting::starting
