::
limited::limited
consolidated::consolidated
dynamic::dynamic
four::four
exemplied::exemplied
integrity::integrity
suciently::suciently
relationships::relationships
increase::increase
t-closeness::t-closeness
segments::segments
gupta::gupta
under::under
@::@
updated::updated
desirable::desirable
every::every
updates::updates
summarized::summarized
tutoral::tutoral
chawathe::chawathe
solution::solution
296::296
entropy::entropy
shenitzer::shenitzer
force::force
ches::ches
consistent::consistent
estimates::estimates
second::second
49::49
liao::liao
chen::chen
estimated::estimated
expressive::expressive
even::even
errors::errors
preferences::preferences
riedewald::riedewald
selected::selected
reasoning::reasoning
above::above
toll::toll
new::new
increasing::increasing
simultaneously::simultaneously
password-protect::password-protect
drer::drer
here::here
ianywhere::ianywhere
reported::reported
protection::protection
granularity::granularity
active::active
path::path
obtained::obtained
rfid-enabled::rfid-enabled
cayuga::cayuga
items::items
employees::employees
changed::changed
approaches::approaches
california::california
suitable::suitable
changes::changes
augments::augments
highly::highly
undesirable::undesirable
counts::counts
unit::unit
would::would
negative::negative
vol::vol
therefore::therefore
type::type
until::until
701710::701710
brainard::brainard
relax::relax
composite::composite
brings::brings
expose::expose
aware::aware
equipments::equipments
correspondingly::correspondingly
real-time::real-time
blocking::blocking
must::must
springer::springer
1992::1992
locked::locked
room::room
1999::1999
work::work
cost-sensitive::cost-sensitive
containment::containment
merely::merely
root::root
example::example
wang::wang
preserving::preserving
organized::organized
want::want
times::times
end::end
gid1::gid1
thing::thing
provide::provide
damage::damage
krishnaprasad::krishnaprasad
how::how
perishable::perishable
widespread::widespread
massive::massive
multi-level::multi-level
abstraction::abstraction
description::description
srivasatava::srivasatava
after::after
hong::hong
michelakis::michelakis
predicates::predicates
lau::lau
law::law
cuboids::cuboids
las::las
undesired::undesired
gidr::gidr
gids::gids
baggage::baggage
complexity::complexity
algorithms::algorithms
things::things
operate::operate
order::order
gidk::gidk
operations::operations
executed::executed
consent::consent
over::over
vary::vary
x.id::x.id
eavesdropping::eavesdropping
before::before
ime::ime
personal::personal
exhibits::exhibits
writing::writing
distinguishing::distinguishing
persist::persist
strength::strength
eugene::eugene
kriplean::kriplean
then::then
them::them
combination::combination
privacy-friendly::privacy-friendly
they::they
represents::represents
inventory::inventory
l::l
379::379
378::378
bono::bono
reasonable::reasonable
each::each
371::371
370::370
373::373
372::372
375::375
374::374
377::377
376::376
schemes::schemes
financial::financial
fairly::fairly
ecient::ecient
principles::principles
singulation::singulation
used::used
combining::combining
principled::principled
entered-room::entered-room
20071102::20071102
klabjan::klabjan
network::network
driving::driving
tried::tried
urbana::urbana
content::content
re::re
nite::nite
reader::reader
size::size
sliding::sliding
independence::independence
non-occurrence::non-occurrence
little::little
assures::assures
enhance::enhance
detecting::detecting
eective::eective
shelves::shelves
starts::starts
inexpensive::inexpensive
correctness::correctness
eavesdroppers::eavesdroppers
kohno::kohno
corrections::corrections
moving::moving
broken::broken
onto::onto
cleaning::cleaning
already::already
features::features
hoshino::hoshino
subtlety::subtlety
primary::primary
rfid-tagged::rfid-tagged
restrict::restrict
wheelchairs::wheelchairs
another::another
schaper::schaper
electronic::electronic
condence::condence
ozal::ozal
service::service
similarly::similarly
top::top
needed::needed
observations::observations
percentage::percentage
enhancing::enhancing
alonso::alonso
serve::serve
tokens::tokens
incur::incur
somewhat::somewhat
distance::distance
tree::tree
likely::likely
project::project
soner::soner
k::k
prone::prone
acquisition::acquisition
enhancement::enhancement
rao::rao
spectrum::spectrum
raw::raw
manner::manner
jerey::jerey
seen::seen
tells::tells
relatively::relatively
implemented::implemented
concrete::concrete
latter::latter
sound::sound
us.ibm.com::us.ibm.com
forces::forces
transmit::transmit
correlating::correlating
though::though
object::object
what::what
regular::regular
organization::organization
garnkel::garnkel
observation::observation
medical::medical
m::m
inferred::inferred
competitors::competitors
accounted::accounted
tech::tech
principle::principle
tatbul::tatbul
consumer::consumer
incomplete::incomplete
incorporate::incorporate
aquatic::aquatic
autoid::autoid
checks::checks
random::random
ending::ending
radio::radio
solutions::solutions
rector::rector
keywords::keywords
guiasu::guiasu
nevada::nevada
availability::availability
powering::powering
rfids::rfids
proposed::proposed
implementation::implementation
jiawei::jiawei
semantics::semantics
jeery::jeery
do::do
sense::sense
cryptography::cryptography
10::10
nding::nding
criticized::criticized
watson::watson
pallets::pallets
flowcubes::flowcubes
report::report
impractical::impractical
onboard::onboard
w.m::w.m
method::method
bag::bag
traversed::traversed
architecture::architecture
analytical::analytical
automatic::automatic
bai::bai
respond::respond
traverse::traverse
livny::livny
detection::detection
analytics::analytics
depends::depends
result::result
fail::fail
best::best
techniques::techniques
capacity::capacity
publish/subscribe::publish/subscribe
04::04
away::away
flowcube::flowcube
propagates::propagates
unable::unable
368::368
369::369
366::366
367::367
364::364
365::365
approach::approach
363::363
360::360
361::361
we::we
terms::terms
extend::extend
nature::nature
modify::modify
however::however
380::380
381::381
wu::wu
upfront::upfront
modeling::modeling
improve::improve
received::received
essentially::essentially
triggers::triggers
credit-card::credit-card
conclusions::conclusions
constructed::constructed
eciency::eciency
logic::logic
sullivan::sullivan
2nd::2nd
represented::represented
unprotected::unprotected
privacy-preserving::privacy-preserving
loaded::loaded
conference::conference
pseudonyms::pseudonyms
basis::basis
warehouses::warehouses
three::three
been::been
extraction::extraction
much::much
basic::basic
expected::expected
flexible::flexible
nally::nally
life::life
attacker::attacker
agrawal::agrawal
applied::applied
save::save
tradeos::tradeos
luggage::luggage
n::n
near::near
property::property
-diversity::-diversity
leaves::leaves
juels::juels
horvitz-thompson::horvitz-thompson
entity-relation::entity-relation
is::is
it::it
dicult::dicult
ii::ii
exit-reading::exit-reading
experts::experts
il::il
in::in
welbourne::welbourne
seattle::seattle
id::id
if::if
containing::containing
perform::perform
suggest::suggest
make::make
d.w::d.w
linked::linked
complex::complex
split::split
chakravarthy::chakravarthy
incorrectly::incorrectly
several::several
independent::independent
satellite::satellite
density-based::density-based
inadvertently::inadvertently
cross-reads::cross-reads
hand::hand
declarative::declarative
96-bit::96-bit
kim::kim
potentials::potentials
positives::positives
hipac::hipac
cycle::cycle
read-history::read-history
maximizing::maximizing
scenario::scenario
practices::practices
the::the
paradigm::paradigm
corporate::corporate
epc::epc
left::left
protocol::protocol
just::just
dened::dened
assigned::assigned
proposes::proposes
identify::identify
transforms::transforms
facts::facts
32::32
bit::bit
previous::previous
unique::unique
han::han
cost-conscious::cost-conscious
regarded::regarded
advancement::advancement
passive::passive
tuples::tuples
easy::easy
technological::technological
has::has
sql-like::sql-like
usable::usable
dominikus::dominikus
advances::advances
possible::possible
ecommerce/rfid/sjsrfid/rfid.html::ecommerce/rfid/sjsrfid/rfid.html
background::background
30::30
clustered::clustered
poses::poses
occurring::occurring
thakkar::thakkar
specic::specic
59::59
58::58
55::55
54::54
57::57
56::56
51::51
50::50
53::53
52::52
arbitrary::arbitrary
rarely::rarely
security::security
mis-classication::mis-classication
performing::performing
old::old
people::people
sends::sends
successfully::successfully
dead::dead
temporally::temporally
meters::meters
tutorial::tutorial
eventbased::eventbased
cooper::cooper
tracked::tracked
for::for
communications::communications
electromagnetic::electromagnetic
individuals::individuals
exible::exible
espionage::espionage
core::core
lampe::lampe
imeout::imeout
yorks::yorks
archived::archived
delity::delity
peex::peex
binomial::binomial
manufacturing::manufacturing
properties::properties
chapter::chapter
obj::obj
eavesdropper::eavesdropper
o::o
probabilities::probabilities
slightly::slightly
automatically::automatically
considerations::considerations
primitive::primitive
presence::presence
low-cost::low-cost
down::down
right::right
reducing::reducing
often::often
rely::rely
compression::compression
abstractions::abstractions
support::support
transform::transform
class::class
privacypreservation::privacypreservation
shmueli::shmueli
gid::gid
wolkerstorfer::wolkerstorfer
authorized::authorized
fraction::fraction
was::was
war::war
asset::asset
lowest::lowest
form::form
wireless::wireless
failure::failure
incorporation::incorporation
encoded::encoded
cidr::cidr
removed::removed
true::true
reset::reset
portions::portions
prevents::prevents
radio-frequency::radio-frequency
attached::attached
maximum::maximum
devices::devices
different::different
gould::gould
stages::stages
emit::emit
khoussainova::khoussainova
trio::trio
computing::computing
covert::covert
abstract::abstract
decrypt::decrypt
han_mmrfid/::han_mmrfid/
ship::ship
trip::trip
physical::physical
ni::ni
protested::protested
encrypt::encrypt
no::no
whereas::whereas
when::when
ny::ny
interested::interested
warehouse::warehouse
pseudonym::pseudonym
node::node
models::models
polite::polite
sql::sql
variable::variable
unlocking::unlocking
ashish::ashish
rfid-embedded::rfid-embedded
longer::longer
together::together
sibert::sibert
dene::dene
time::time
concept::concept
managed::managed
chain::chain
global::global
leads::leads
roy::roy
manager::manager
computation::computation
battle::battle
-chip::-chip
zone::zone
technique::technique
environment::environment
0::0
encrypted::encrypted
brown::brown
indoor::indoor
string::string
advantage::advantage
cheap::cheap
owgraphs::owgraphs
seemingly::seemingly
choice::choice
security-protection::security-protection
vegas::vegas
stays::stays
partitions::partitions
materialize::materialize
ubicomp07::ubicomp07
level::level
turns::turns
item::item
science::science
accumulation::accumulation
prevent::prevent
slower::slower
occurrence::occurrence
trend::trend
trails::trails
maximization::maximization
381394::381394
multi-tag::multi-tag
cost::cost
port::port
curse::curse
application-independent::application-independent
appear::appear
gehrke::gehrke
uniform::uniform
current::current
sequential::sequential
bornhovd::bornhovd
relational::relational
axed::axed
supporting::supporting
weis::weis
v::v
groups::groups
along::along
implanted::implanted
change::change
incoming::incoming
shift::shift
commonly::commonly
single-tag::single-tag
simultaneous::simultaneous
franklin::franklin
usually::usually
eectively::eectively
tasks::tasks
useful::useful
carids::carids
rule-based::rule-based
ips::ips
deployments::deployments
mobil::mobil
hierarchically::hierarchically
handled::handled
positive::positive
scan::scan
by::by
scenarios::scenarios
handles::handles
opposed::opposed
criteria::criteria
cryptographically::cryptographically
sharing::sharing
acceptable::acceptable
equipped::equipped
oregon::oregon
articleview/592/1/1::articleview/592/1/1
virtue::virtue
cases::cases
insights::insights
ibm::ibm
calmels::calmels
car::car
anti-collision::anti-collision
attacks::attacks
labeled::labeled
aircrafts::aircrafts
can::can
following::following
making::making
feature::feature
dierence::dierence
stream::stream
attribute::attribute
chip::chip
enablement::enablement
sample::sample
dropped::dropped
allowed::allowed
clothing::clothing
occur::occur
verlag::verlag
redundancy::redundancy
monitoring::monitoring
discussion::discussion
1::1
rubin::rubin
pins::pins
parameter::parameter
inputs::inputs
product::product
5.1::5.1
may::may
unobtrusive::unobtrusive
user-stated::user-stated
applications::applications
explored::explored
designed::designed
date::date
such::such
data::data
recursive::recursive
natural::natural
commodity::commodity
explicit::explicit
compressing::compressing
switch::switch
so::so
representation::representation
balazinska::balazinska
2531::2531
typical::typical
extractor::extractor
tagged::tagged
shoes::shoes
blocker::blocker
years::years
course::course
canard::canard
statistical::statistical
argued::argued
still::still
ieee::ieee
blocked::blocked
emits::emits
molnar::molnar
interesting::interesting
vicinity::vicinity
covertly::covertly
policy::policy
main::main
texas::texas
thereby::thereby
views::views
matches::matches
smarter::smarter
aes::aes
records::records
not::not
sorted::sorted
now::now
discuss::discuss
developments::developments
lineage::lineage
name::name
h::h
imein::imein
domain::domain
langheinrich::langheinrich
re-writable::re-writable
challenges::challenges
zebra::zebra
ep::ep
er::er
gonzalez::gonzalez
shown::shown
space::space
value-bed::value-bed
furthermore::furthermore
ezpass::ezpass
collisions::collisions
internet::internet
sensor::sensor
correct::correct
shows::shows
anwar::anwar
contain::contain
mechanisms::mechanisms
possibility::possibility
quite::quite
103111::103111
advantages::advantages
besides::besides
z.id::z.id
language::language
1994::1994
turn::turn
place::place
aboard::aboard
misused::misused
first::first
intuition::intuition
saving::saving
ignored::ignored
clause::clause
variables::variables
one::one
feldhofer::feldhofer
directly::directly
comprises::comprises
open::open
millions::millions
city::city
given::given
necessarily::necessarily
checked::checked
silent::silent
dalvi::dalvi
participates::participates
response::response
anyone::anyone
physically::physically
returns::returns
2::2
types::types
white::white
gives::gives
mining::mining
way::way
that::that
memo::memo
broadcast::broadcast
attempt::attempt
eliminated::eliminated
than::than
specify::specify
population::population
11::11
wide::wide
13::13
12::12
15::15
14::14
17::17
16::16
19::19
18::18
require::require
accesses::accesses
protected::protected
were::were
cards::cards
gigantic::gigantic
//www.boycotttesco.com:://www.boycotttesco.com
and::and
addressing::addressing
deciphering::deciphering
dynamically::dynamically
locations::locations
any::any
objectlocation::objectlocation
note::note
take::take
disadvantage::disadvantage
online::online
objective::objective
green::green
multiple::multiple
trace::trace
normal::normal
track::track
correlation::correlation
compress::compress
falls::falls
satisfying::satisfying
successive::successive
pair::pair
inserted::inserted
especially::especially
350::350
considered::considered
later::later
implications::implications
sale::sale
managing::managing
typically::typically
quantity::quantity
precise::precise
show::show
counter-reading::counter-reading
discovered::discovered
inconsistent::inconsistent
threshold::threshold
fifth::fifth
daily::daily
3::3
multiple-tag::multiple-tag
september::september
only::only
explicitly::explicitly
developed::developed
dyn::dyn
conjunction::conjunction
ssc::ssc
rfidenabled::rfidenabled
outperform::outperform
summary::summary
where::where
transmits::transmits
borriello::borriello
kernel::kernel
10532::10532
cost-eectiveness::cost-eectiveness
imposing::imposing
actively::actively
us::us
k-anonymity::k-anonymity
concern::concern
fails::fails
detect::detect
auto-id::auto-id
rfid/nfc::rfid/nfc
ways::ways
label::label
boundaries::boundaries
behind::behind
mcmanus::mcmanus
between::between
timein::timein
lahar::lahar
reading::reading
across::across
infrastructure::infrastructure
parent::parent
receivers::receivers
supermarket::supermarket
killing::killing
come::come
dates::dates
8-bit::8-bit
acquiring::acquiring
many::many
1724::1724
hours::hours
according::according
enabling::enabling
s::s
patrons::patrons
stream-oriented::stream-oriented
tradeo::tradeo
expression::expression
comes::comes
overview::overview
semi-passive::semi-passive
ltering::ltering
period::period
sampling::sampling
60::60
61::61
maintained::maintained
63::63
jammed::jammed
65::65
66::66
67::67
68::68
associated::associated
combines::combines
encryption::encryption
detected::detected
sheth::sheth
workshop::workshop
combined::combined
technical::technical
engine::engine
direction::direction
blessing::blessing
readings::readings
surreptitiously::surreptitiously
aected::aected
bayesian::bayesian
suciu::suciu
careful::careful
those::those
case::case
buer::buer
developing::developing
these::these
engineering::engineering
w::w
ohkubo::ohkubo
garofalakis::garofalakis
policies::policies
situation::situation
edgepro-053107-wp.pdf::edgepro-053107-wp.pdf
characteristics::characteristics
health-care::health-care
converts::converts
ambient::ambient
technology::technology
everyday::everyday
movements::movements
binary::binary
par::par
girault::girault
locking::locking
same::same
check::check
authentication::authentication
speedpass::speedpass
buys::buys
document::document
hellerstein::hellerstein
events::events
week::week
extended::extended
disadvantages::disadvantages
rfid::rfid
changing::changing
implements::implements
tracking::tracking
minimize::minimize
ccs::ccs
without::without
components::components
model::model
dimension::dimension
malicious::malicious
transmitting::transmitting
captures::captures
actions::actions
compromising::compromising
kill::kill
aspect::aspect
captured::captured
76::76
euros::euros
except::except
pallet::pallet
4::4
anamolies::anamolies
real::real
aspects::aspects
around::around
rules::rules
photocopier::photocopier
epcs::epcs
listening::listening
using::using
accepted::accepted
correcting::correcting
dare::dare
readwriteweb::readwriteweb
intel::intel
identifying::identifying
application-specic::application-specic
reduces::reduces
62::62
server::server
discarded::discarded
group-wise::group-wise
t::t
doraiswamy::doraiswamy
64::64
stationary::stationary
reduced::reduced
spans::spans
69::69
matching::matching
generates::generates
provided::provided
dimensions::dimensions
unlocked::unlocked
recorded::recorded
critical::critical
exit::exit
provides::provides
edbt::edbt
semantically::semantically
cleansed::cleansed
conicting::conicting
timeout::timeout
business::business
equivalent::equivalent
trials::trials
inherent::inherent
manufacturer::manufacturer
on::on
conducting::conducting
stations::stations
of::of
discussed::discussed
develops::develops
acm::acm
tremendous::tremendous
greatly::greatly
discusses::discusses
or::or
landt::landt
shoplifting::shoplifting
communication::communication
fishkin::fishkin
carey::carey
references::references
determine::determine
operator::operator
technically::technically
area::area
assumed::assumed
there::there
start::start
unreliability::unreliability
low::low
strong::strong
assumes::assumes
complete::complete
sophisticated::sophisticated
unreliable::unreliable
technologies::technologies
with::with
faster::faster
fraud::fraud
arranged::arranged
embedded::embedded
default::default
shelf-reading::shelf-reading
unveils::unveils
embed::embed
beliefs::beliefs
vehicles::vehicles
videos::videos
resolving::resolving
moved::moved
an::an
examine::examine
scanned::scanned
at::at
formulation::formulation
pay-at-pump::pay-at-pump
corresponding::corresponding
again::again
4.1::4.1
antenna::antenna
whitepaper::whitepaper
storage::storage
5::5
spatial::spatial
plan-based::plan-based
pappu::pappu
separate::separate
durations::durations
hawthorne::hawthorne
important::important
ashton::ashton
included::included
traversal::traversal
building::building
dbn-based::dbn-based
remote::remote
mask::mask
u::u
krishnamurthy::krishnamurthy
apparel::apparel
starting::starting
original::original
represent::represent
all::all
semantic::semantic
consider::consider
duplicates::duplicates
sub-sequence::sub-sequence
follow::follow
decisions::decisions
children::children
causes::causes
rd::rd
tu::tu
opportunities::opportunities
to::to
m.-t::m.-t
protocols::protocols
nodes::nodes
te::te
mid-nineties::mid-nineties
demers::demers
activities::activities
very::very
debit::debit
fan::fan
concatenating::concatenating
treating::treating
evaluation::evaluation
applicable::applicable
large::large
mitautoidwh014::mitautoidwh014
small::small
5.2::5.2
hitachi::hitachi
sql-based::sql-based
design::design
perspective::perspective
further::further
diao::diao
ramachandran::ramachandran
consumers::consumers
sun::sun
section::section
version::version
inferences::inferences
stubbleeld::stubbleeld
public::public
movement::movement
full::full
installations::installations
tags::tags
component::component
ranges::ranges
selective::selective
compressed::compressed
i.e::i.e
urbana-champaign::urbana-champaign
fan-in::fan-in
5.5::5.5
allows::allows
transponder::transponder
prior::prior
amount::amount
social::social
exited::exited
uniquely::uniquely
via::via
followed::followed
analyzing::analyzing
appliances::appliances
sensors::sensors
conventional::conventional
takes::takes
fujimura::fujimura
distinct::distinct
contains::contains
two::two
comparing::comparing
automate::automate
6::6
taken::taken
authorization::authorization
more::more
nonredundant::nonredundant
modication::modication
readers::readers
operators::operators
constructs::constructs
particular::particular
known::known
mounted::mounted
hour::hour
edakkunni::edakkunni
created::created
sequence-based::sequence-based
remain::remain
learn::learn
smurf::smurf
history::history
challenging::challenging
stated::stated
specied::specied
boycott::boycott
collision::collision
minimum::minimum
protects::protects
arise::arise
lacks::lacks
species::species
!::!
information::information
needs::needs
5.3::5.3
5.4::5.4
goal::goal
immobilizers::immobilizers
rather::rather
plans::plans
cleansing::cleansing
centimeters::centimeters
simplicity::simplicity
ubiquitous::ubiquitous
intended::intended
derived::derived
mapping::mapping
connectivity::connectivity
coming::coming
invasion::invasion
lifecycle::lifecycle
a::a
short::short
parameterized::parameterized
interpolates::interpolates
specifying::specifying
instrumentss::instrumentss
patil::patil
help::help
disables::disables
hierarchy::hierarchy
essence::essence
per-tuple::per-tuple
paper::paper
through::through
921.75::921.75
its::its
24::24
25::25
26::26
27::27
20::20
21::21
22::22
23::23
28::28
29::29
absence::absence
pac::pac
systems::systems
//www.sybase.com/files/white_papers/sybaserfid_:://www.sybase.com/files/white_papers/sybaserfid_
focussed::focussed
identiable::identiable
return::return
dening::dening
food::food
timestamp::timestamp
burkhart::burkhart
framework::framework
formulating::formulating
yu::yu
association::association
kleap::kleap
easily::easily
products::products
always::always
capability::capability
found::found
ports::ports
referred::referred
brunette::brunette
formulate::formulate
swedberg::swedberg
energy::energy
hard::hard
reduce::reduce
idea::idea
ifip::ifip
deterministically::deterministically
modied::modied
operation::operation
beyond::beyond
event::event
missed::missed
p::p
since::since
research::research
participants::participants
safety::safety
7::7
print::print
issue::issue
occurs::occurs
ask::ask
8486::8486
earliest::earliest
generate::generate
//www.boycottbenetton.com:://www.boycottbenetton.com
omit::omit
threat::threat
floerkemeier::floerkemeier
major::major
probability::probability
relate::relate
number::number
preservation::preservation
traveled::traveled
dejavu::dejavu
done::done
least::least
luggage_rfid.php::luggage_rfid.php
temperature::temperature
introduction::introduction
automobile::automobile
interact::interact
construct::construct
assumption::assumption
passed::passed
scheme::scheme
store::store
too::too
relationship::relationship
recursively::recursively
internet-enabled::internet-enabled
pipelined::pipelined
privacy-protection::privacy-protection
kind::kind
b::b
determines::determines
stall::stall
//www.readwriteweb.com/archives/the_end_of_lost_:://www.readwriteweb.com/archives/the_end_of_lost_
gps::gps
treated::treated
cleaner::cleaner
liabilities::liabilities
immerman::immerman
meta-id::meta-id
cleaned::cleaned
vulnerable::vulnerable
reiss::reiss
pertec07::pertec07
paths::paths
time-stamp::time-stamp
built::built
patterns::patterns
lin::lin
meta-identiers::meta-identiers
majority::majority
costs::costs
generalized::generalized
command::command
exploit::exploit
towards::towards
programmers::programmers
measures::measures
charu::charu
77::77
most::most
75::75
74::74
experiences::experiences
72::72
71::71
70::70
services::services
infrastructures::infrastructures
extremely::extremely
79::79
78::78
deviations::deviations
centintemel::centintemel
unequal::unequal
mobile::mobile
clear::clear
sometimes::sometimes
traditional::traditional
proliferated::proliferated
clean::clean
bulletin::bulletin
ambiguities::ambiguities
particularly::particularly
sensorlocation::sensorlocation
unland::unland
carefully::carefully
networks::networks
cell::cell
meta-information::meta-information
merges::merges
distributed::distributed
being::being
colby::colby
subsection::subsection
money::money
8::8
dependent::dependent
wagner::wagner
october::october
grocery::grocery
cheaper::cheaper
theft::theft
collins::collins
combinations::combinations
during::during
contextual::contextual
enemy::enemy
resolve::resolve
querying::querying
generally::generally
remove::remove
underlying::underlying
activity::activity
x::x
locating::locating
scanning::scanning
set::set
seq::seq
achieved::achieved
enabled::enabled
individual::individual
are::are
tag-presence::tag-presence
repairs::repairs
threats::threats
tolls::tolls
libraries::libraries
smallest::smallest
probably::probably
conditions::conditions
available::available
recently::recently
responses::responses
missing::missing
complement::complement
piramuthu::piramuthu
selectively::selectively
szydlo::szydlo
both::both
c::c
last::last
sensitive::sensitive
context::context
extracting::extracting
experimental::experimental
upgraded::upgraded
point::point
battery::battery
corresponds::corresponds
wen::wen
instants::instants
throughout::throughout
expensive::expensive
pp::pp
java::java
stamp::stamp
create::create
acceptance::acceptance
complicated::complicated
collected::collected
meeting::meeting
sarma::sarma
determination::determination
representative::representative
assigning::assigning
unnecessarily::unnecessarily
stolen::stolen
uncertain::uncertain
deferred::deferred
while::while
optimization::optimization
replaced::replaced
smart::smart
behavior::behavior
error::error
2k::2k
designing::designing
adjusts::adjusts
cents::cents
probabilistically::probabilistically
reads::reads
itself::itself
attach::attach
aipperspach::aipperspach
authenticated::authenticated
read::read
widely::widely
peoples::peoples
9::9
resulting::resulting
higher::higher
signicantly::signicantly
cost-eective::cost-eective
keys::keys
assignment::assignment
flows::flows
domains::domains
moment::moment
levels::levels
uses::uses
user::user
aggregate::aggregate
robust::robust
recent::recent
meta-tag::meta-tag
lower::lower
automaton::automaton
database::database
depending::depending
analysis::analysis
landmarc::landmarc
person::person
edge::edge
y::y
entry::entry
//www.rfidjournal.com/article/articleview/337/:://www.rfidjournal.com/article/articleview/337/
kernel-based::kernel-based
observed::observed
competitive::competitive
inactive::inactive
world::world
inference::inference
tables::tables
execution::execution
also::also
workers::workers
signals::signals
source::source
causing::causing
location::location
input::input
transformation::transformation
useless::useless
associations::associations
march::march
emergency::emergency
aggregation::aggregation
emergence::emergence
formal::formal
d::d
systematically::systematically
follows::follows
signal::signal
peexl::peexl
jauhari::jauhari
banknotes::banknotes
collect::collect
imposes::imposes
popular::popular
essential::essential
mathematical::mathematical
identication::identication
caspian::caspian
methods::methods
some::some
back::back
streaming::streaming
trends::trends
added::added
examples::examples
sight::sight
3.1::3.1
5763::5763
abdelzaher::abdelzaher
scale::scale
pet::pet
decision::decision
transactions::transactions
per::per
singles::singles
szydylo::szydylo
behave::behave
j.-g::j.-g
either::either
be::be
patient::patient
processing::processing
continuing::continuing
consignments::consignments
restrictive::restrictive
step::step
negatives::negatives
santa::santa
prexes::prexes
feb::feb
readability::readability
raymer::raymer
goods::goods
consumption::consumption
constraint::constraint
kinoshita::kinoshita
path-independent::path-independent
ids::ids
range::range
involving::involving
extensions::extensions
//java.sun.com/developer/technicalarticles/:://java.sun.com/developer/technicalarticles/
73::73
block::block
plan::plan
aggarwal::aggarwal
into::into
within::within
primarily::primarily
data-centric::data-centric
span::span
spam::spam
probabilistic::probabilistic
placing::placing
live::live
long::long
identiers::identiers
kdd::kdd
refrigerator::refrigerator
tancau::tancau
translate::translate
irstr03012::irstr03012
opens::opens
prex::prex
manufacture::manufacture
memory::memory
properly::properly
link::link
newer::newer
line::line
considerable::considerable
info::info
icde::icde
cikm::cikm
characteristic::characteristic
middleware::middleware
up::up
miniaturization::miniaturization
international::international
windows::windows
continuously::continuously
z::z
similar::similar
called::called
uc::uc
storing::storing
constant::constant
specication::specication
stripped::stripped
single::single
codes::codes
%::%
tesco::tesco
application::application
points::points
functionality::functionality
department::department
362::362
users::users
problems::problems
helping::helping
generated::generated
allowing::allowing
workow::workow
identiability::identiability
aggregated::aggregated
cryptographic::cryptographic
265289::265289
correlated::correlated
implies::implies
algorithm::algorithm
required::required
denition::denition
2002::2002
2003::2003
depth::depth
2006::2006
2007::2007
2004::2004
2005::2005
far::far
failures::failures
2008::2008
2009::2009
requires::requires
once::once
code::code
partial::partial
vldb::vldb
results::results
existing::existing
softer::softer
go::go
query::query
issues::issues
transacted::transacted
send::send
languages::languages
uniqueness::uniqueness
sens::sens
tree-size::tree-size
friendly::friendly
sent::sent
expressing::expressing
telling::telling
categories::categories
entire::entire
transmission::transmission
lter::lter
integrating::integrating
fewer::fewer
try::try
olap::olap
?::?
logistics::logistics
locate::locate
smaller::smaller
adaikkalavan::adaikkalavan
y.id::y.id
video::video
picked::picked
dynamics::dynamics
device-independent::device-independent
power::power
group-based::group-based
rastogi::rastogi
access::access
values::values
;::;
saps::saps
non-linear::non-linear
lee::lee
leveraging::leveraging
commercial::commercial
adma::adma
desired::desired
explore::explore
objects::objects
mayjune::mayjune
separation::separation
others::others
39::39
38::38
warehousing::warehousing
33::33
involved::involved
31::31
larger::larger
37::37
36::36
35::35
34::34
survey::survey
defeat::defeat
makes::makes
maker::maker
formulated::formulated
manage::manage
clara::clara
gehani::gehani
addressed::addressed
use::use
from::from
usa::usa
illegal::illegal
zaniolo::zaniolo
next::next
few::few
duplicate::duplicate
vehicle::vehicle
themselves::themselves
simpler::simpler
letchner::letchner
possession::possession
1/1::1/1
started::started
becomes::becomes
zimmer::zimmer
occurred::occurred
carrying::carrying
detects::detects
customer::customer
engels::engels
account::account
animals::animals
f::f
this::this
challenge::challenge
anywhere::anywhere
drill::drill
cs.uiuc.edu::cs.uiuc.edu
performed::performed
control::control
links::links
process::process
purposes::purposes
high::high
tag::tag
serial::serial
akdere::akdere
purpose::purpose
six::six
negation::negation
animal::animal
instead::instead
furnace::furnace
airline::airline
buildings::buildings
collection::collection
requirements::requirements
computations::computations
light::light
counter::counter
rules-based::rules-based
correspond::correspond
redundant::redundant
allow::allow
healthcare::healthcare
subsequently::subsequently
139165::139165
epc-tagged::epc-tagged
move::move
interpreted::interpreted
including::including
write::write
multi-dimensional::multi-dimensional
temporal::temporal
rfid-based::rfid-based
dierently::dierently
ticular::ticular
tstart::tstart
2011::2011
<::<
2013::2013
greater::greater
auto::auto
practice::practice
satellites::satellites
minimalist::minimalist
airports::airports
trac::trac
university::university
merge::merge
transmitted::transmitted
constraints::constraints
subset::subset
map::map
gyllstrom::gyllstrom
related::related
society::society
frequency::frequency
static::static
tree-walking::tree-walking
measure::measure
82::82
83::83
80::80
81::81
out::out
maximizes::maximizes
performs::performs
dindhar::dindhar
lecture::lecture
adaptive::adaptive
cause::cause
integrated::integrated
high-performance::high-performance
interactions::interactions
maintains::maintains
reader-tag::reader-tag
release::release
completely::completely
wpes::wpes
likelihood::likelihood
steering::steering
interaction::interaction
g::g
could::could
keep::keep
produce::produce
qualification::qualification
retail::retail
facilitate::facilitate
transmitters::transmitters
powerful::powerful
reaches::reaches
strategic::strategic
representations::representations
owner::owner
smoothing::smoothing
destinations::destinations
management::management
micro-cluster::micro-cluster
privacy::privacy
system::system
their::their
attack::attack
intelligence::intelligence
scans::scans
pervasive::pervasive
enforcement::enforcement
liang::liang
tuple::tuple
606617::606617
shelf::shelf
rivest::rivest
state-based::state-based
rst::rst
branches::branches
july::july
overwhelming::overwhelming
misclassication::misclassication
zones::zones
privacy-preservation::privacy-preservation
subsequence::subsequence
squealing::squealing
providing::providing
distinguished::distinguished
exhibit::exhibit
false::false
discussions::discussions
usenix::usenix
have::have
need::need
clearly::clearly
viewed::viewed
able::able
mechanism::mechanism
instance::instance
concerns::concerns
which::which
truck::truck
detector::detector
=::=
mit::mit
accuracy::accuracy
device::device
cloned::cloned
expired::expired
payment::payment
consequences::consequences
gather::gather
metaphysical::metaphysical
proceedings::proceedings
construction::construction
snapshot::snapshot
databases::databases
streamclean::streamclean
normally::normally
event-based::event-based
fact::fact
komuro::komuro
spatiotemporal::spatiotemporal
selection::selection
dbn::dbn
454469::454469
price-point::price-point
supported::supported
planning::planning
parked::parked
congured::congured
high-level::high-level
subsections::subsections
based::based
knowledge::knowledge
credited::credited
should::should
entities::entities
tape::tape
ambiguity::ambiguity
thousands::thousands
handle::handle
means::means
familiar::familiar
joint::joint
ones::ones
legitimate::legitimate
joins::joins
timing::timing
applying::applying
reusable::reusable
entity::entity
chips::chips
exibility::exibility
areas::areas
queried::queried
liu::liu
processes::processes
widom::widom
unauthorized::unauthorized
ended::ended
numerous::numerous
mobide06::mobide06
window-based::window-based
queries::queries
cycles::cycles
view::view
constructing::constructing
guc::guc
computer::computer
closer::closer
cole::cole
record::record
pattern::pattern
opt-out::opt-out
tend::tend
state::state
easure::easure
sold::sold
bought::bought
ability::ability
importance::importance
key::key
instant::instant
382::382
etc::etc
streams::streams
attributes::attributes
passing::passing
otherwise::otherwise
adjusted::adjusted
relevant::relevant
cd::cd
ab::ab
maximize::maximize
sequences::sequences
table::table
li::li
re-encrypt::re-encrypt
rdbms::rdbms
powered::powered
addition::addition
trajectory::trajectory
window::window
slowly::slowly
certain::certain
>::>
arises::arises
diversity::diversity
protect::protect
sensed::sensed
general::general
present::present
splits::splits
unlike::unlike
contexts::contexts
as::as
value::value
2010::2010
will::will
wild::wild
ku::ku
haller::haller
supply::supply
layer::layer
uncertainty::uncertainty
thus::thus
hardware::hardware
w.-s::w.-s
against::against
sequentially::sequentially
denial::denial
parts::parts
dierent::dierent
largest::largest
infer::infer
http::http
workows::workows
upon::upon
blockers::blockers
hanj::hanj
architectures::architectures
frequently::frequently
transaction::transaction
center::center
modeled::modeled
well::well
subtree::subtree
357::357
356::356
355::355
354::354
353::353
352::352
351::351
sets::sets
position::position
user-friendly::user-friendly
sensing::sensing
359::359
358::358
xed::xed
routinely::routinely
less::less
increasingly::increasingly
proximity::proximity
numbering::numbering
obtain::obtain
43::43
sources::sources
stored::stored
40::40
41::41
sku::sku
web::web
rapid::rapid
density::density
large-scale::large-scale
drawback::drawback
simple::simple
ubicomp::ubicomp
other::other
maintaining::maintaining
match::match
increased::increased
jagadish::jagadish
worlds::worlds
//videolectures.net/kdd08_:://videolectures.net/kdd08_
know::know
immediately::immediately
password::password
insert::insert
check-out::check-out
like::like
lost::lost
sizes::sizes
alternatively::alternatively
garage::garage
mhz::mhz
become::become
works::works
soft::soft
e::e
accessible::accessible
because::because
sequence::sequence
shen::shen
library::library
proper::proper
//www.rfidjournal.com/article/:://www.rfidjournal.com/article/
snoopib::snoopib
lead::lead
broad::broad
avoid::avoid
sigmod::sigmod
overlap::overlap
does::does
demonstrated::demonstrated
limitations::limitations
noise::noise
inaccurate::inaccurate
journal::journal
curtails::curtails
pressure::pressure
host::host
r::r
adversary::adversary
noisy::noisy
about::about
actual::actual
carried::carried
extension::extension
column::column
introduces::introduces
recognized::recognized
carries::carries
introduced::introduced
software::software
own::own
previously::previously
washington::washington
bridging::bridging
tiny::tiny
estimators::estimators
ows::ows
utility::utility
1985::1985
additional::additional
signicant::signicant
1988::1988
noticed::noticed
interval-based::interval-based
troubling::troubling
suzuki::suzuki
naturally::naturally
function::function
buy::buy
rizvi::rizvi
triggered::triggered
but::but
volume::volume
repeated::repeated
hierarchical::hierarchical
gain::gain
automated::automated
made::made
places::places
whether::whether
ecosystem::ecosystem
cells::cells
j::j
placed::placed
below::below
benetton::benetton
problem::problem
owgraph::owgraph
pin::pin
october/november::october/november
ing::ing
inc::inc
sase::sase
compared::compared
48::48
variety::variety
46::46
47::47
44::44
45::45
42::42
detail::detail
virtual::virtual
illinois::illinois
book::book
details::details
branch::branch
immobilizer::immobilizer
jamming::jamming
monitors::monitors
category::category
kinds::kinds
tannen::tannen
zhou::zhou
percom::percom
inherently::inherently
stay::stay
coupling::coupling
identier::identier
identies::identies
rule::rule
identied::identied
portion::portion
volumes::volumes
pods::pods
