::
all::all
code::code
0::0
chain::chain
aggregating::aggregating
hooks::hooks
out-of-stock::out-of-stock
existing::existing
alien::alien
manager::manager
manages::manages
consists::consists
westwood::westwood
equipment::equipment
sr176::sr176
send::send
environment::environment
to::to
program::program
helps::helps
under::under
nodes::nodes
r/w::r/w
friendly::friendly
assist::assist
@::@
updated::updated
g2::g2
frequencies::frequencies
in/out::in/out
standard-following::standard-following
transponders::transponders
wave::wave
web-service::web-service
condition::condition
supports::supports
solution::solution
standards::standards
large::large
item::item
enhance::enhance
logistics::logistics
abbreviated::abbreviated
facilitating::facilitating
portable::portable
direct::direct
jump::jump
un-deactivated::un-deactivated
cost::cost
click::click
cargo::cargo
power::power
upca::upca
access::access
version::version
above::above
conduct::conduct
new::new
;::;
can::can
supporting::supporting
full::full
transportation::transportation
tags::tags
respectively::respectively
out-of-domain::out-of-domain
modify::modify
active::active
along::along
rs232::rs232
crossbow::crossbow
change::change
intellitag::intellitag
parameters::parameters
items::items
compliance::compliance
allows::allows
experience::experience
all-9354::all-9354
amount::amount
drm::drm
implement::implement
studies::studies
involves::involves
tasks::tasks
addresses::addresses
manage::manage
market::market
use::use
from::from
would::would
&::&
scan::scan
seamless::seamless
scenarios::scenarios
dispatching::dispatching
camera::camera
inlay::inlay
asset::asset
test-bed::test-bed
type::type
90095::90095
more::more
sort::sort
r/o::r/o
ti::ti
visibility::visibility
site::site
tested::tested
ucla-winmec::ucla-winmec
real-time::real-time
antennas::antennas
user-dened::user-dened
iii::iii
capturing::capturing
subscription::subscription
customer::customer
ii::ii
..for::..for
this::this
setup::setup
work::work
e-pedigree::e-pedigree
concepts::concepts
following::following
control::control
compare::compare
processing::processing
activities::activities
process::process
enablement::enablement
winmec::winmec
tag::tag
concept::concept
information::information
provide::provide
1::1
iso::iso
intelligent::intelligent
rewins::rewins
description::description
pdf417::pdf417
internet::internet
lab::lab
diagram::diagram
applications::applications
icode::icode
designed::designed
demonstrating::demonstrating
coming::coming
date::date
such::such
pdc170::pdc170
data::data
engineering::engineering
a::a
short::short
syscan::syscan
third::third
efcient::efcient
representation::representation
restriction::restriction
tenma::tenma
help::help
hierarchy::hierarchy
developed::developed
mission::mission
edge-of-the::edge-of-the
including::including
facilitates::facilitates
windshield::windshield
developer::developer
lf::lf
group::group
directional::directional
platform::platform
notication::notication
systems::systems
self-checking::self-checking
uhf::uhf
then::then
them::them
return::return
combination::combination
misplacement::misplacement
framework::framework
gate::gate
not::not
tektronix::tektronix
association::association
name::name
verifying::verifying
.net::.net
accommodates::accommodates
skyetek::skyetek
capability::capability
each::each
status::status
spider::spider
bluetooth::bluetooth
investigated::investigated
measurement::measurement
our::our
operation::operation
humidity::humidity
event::event
iso18000-6b::iso18000-6b
out::out
//www.winmec.ucla.edu/:://www.winmec.ucla.edu/
accomplish::accomplish
network::network
entertainment::entertainment
samsys9320::samsys9320
research::research
rd::rd
rf::rf
reader::reader
sensor::sensor
integrated::integrated
processed::processed
rfid::rfid
//winmec.ucla.edu/rdlab:://winmec.ucla.edu/rdlab
free::free
standard::standard
collection::collection
tis6350::tis6350
hf/barcodev::hf/barcodev
sensors::sensors
wi-fi::wi-fi
generate::generate
awid::awid
interaction::interaction
programming::programming
motion::motion
mantis::mantis
readers/tags::readers/tags
portal::portal
retail::retail
facilitate::facilitate
assign::assign
speeds::speeds
industrial::industrial
features::features
tag-it/iso15693/icode::tag-it/iso15693/icode
number::number
one::one
customization::customization
message::message
electronic::electronic
smartband::smartband
given::given
management::management
temperature::temperature
service::service
needed::needed
system::system
their::their
-to::-to
//www.wireless.ucla.edu/rd/winrd:://www.wireless.ucla.edu/rd/winrd
in-transit::in-transit
gps::gps
44-116s::44-116s
that::that
omni-directional::omni-directional
shelf::shelf
continuous::continuous
proving::proving
eliminated::eliminated
10::10
database::database
bed::bed
preparation::preparation
enables::enables
tag/reader::tag/reader
false::false
1.1::1.1
topics::topics
measure::measure
winrfid::winrfid
have::have
irda::irda
strength::strength
built::built
transcription::transcription
upgrading::upgrading
rf-code::rf-code
client::client
also::also
without::without
which::which
performance::performance
compliant::compliant
soap::soap
persistence::persistence
rafsec::rafsec
components::components
deploy::deploy
serve::serve
price::price
consistency::consistency
0/1::0/1
most::most
regular::regular
connected::connected
services::services
class::class
wireless::wireless
assisting::assisting
mobile::mobile
alarm::alarm
request::request
sale::sale
mifare::mifare
enterprise::enterprise
microsoft::microsoft
shop::shop
selection::selection
supported::supported
centralized::centralized
relation::relation
solutions::solutions
xml::xml
partners::partners
based::based
simulating::simulating
copyright::copyright
hf::hf
writes::writes
cache::cache
distributed::distributed
operational::operational
only::only
bases::bases
integrate::integrate
sdk::sdk
local::local
2010an/ar::2010an/ar
soon::soon
interoperability::interoperability
meter::meter
exchanges::exchanges
processes::processes
bar::bar
borrow::borrow
cmpct::cmpct
architecture::architecture
through::through
tiris::tiris
cro::cro
set::set
intelligence::intelligence
testing::testing
iso14443b/c::iso14443b/c
module::module
are::are
enhanced::enhanced
protecting::protecting
rfdvd::rfdvd
pattern::pattern
currently::currently
uhf/hf::uhf/hf
phl2700::phl2700
various::various
routing::routing
edge-of-network::edge-of-network
reading::reading
tis6500::tis6500
available::available
we::we
infrastructure::infrastructure
interfaces::interfaces
deliver::deliver
metal::metal
scalability::scalability
key::key
interface::interface
//www.winmec.ucla.edu:://www.winmec.ucla.edu
improve::improve
both::both
c::c
paradigms::paradigms
triggers::triggers
readers::readers
etc::etc
logic::logic
passing::passing
pdc::pdc
and::and
edu/rd::edu/rd
point::point
ca::ca
m/p::m/p
ltering::ltering
code39::code39
reader/tag::reader/tag
packaging::packaging
rpc::rpc
initiative::initiative
eld::eld
angeles::angeles
expensive::expensive
backend::backend
verication::verication
complication::complication
capable::capable
come::come
ucla::ucla
been::been
collected::collected
prototype::prototype
choose::choose
website::website
generating::generating
shopping::shopping
versa::versa
medical/healthcare::medical/healthcare
formed::formed
dynasys::dynasys
protocols::protocols
pilot::pilot
case::case
exception::exception
code128::code128
these::these
mount::mount
single::single
value::value
will::will
policies::policies
radio::radio
layer::layer
mote::mote
ripe::ripe
tag-it::tag-it
is::is
it::it
library/document::library/document
hardware::hardware
reads::reads
reports::reports
in::in
partner::partner
technology::technology
if::if
different::different
perform::perform
media::media
pr100::pr100
administration::administration
dpac/airwave::dpac/airwave
same::same
checking::checking
authentication::authentication
inventory::inventory
party::party
several::several
development::development
independent::independent
used::used
http::http
assigns::assigns
comprehensive::comprehensive
third-party::third-party
upon::upon
automation::automation
uses::uses
scale::scale
robust::robust
identity::identity
tracking::tracking
modes::modes
intermittent::intermittent
well::well
person::person
edge::edge
vendor-specied::vendor-specied
on-the-y::on-the-y
position::position
the::the
sensing::sensing
epc::epc
ean13::ean13
being::being
when::when
accurate::accurate
consortium::consortium
winmec.ucla.edu::winmec.ucla.edu
plug-in::plug-in
condential::condential
web::web
rapid::rapid
console::console
vibration::vibration
supply::supply
capabilities::capabilities
pallet::pallet
add::add
book::book
cost-efcient::cost-efcient
location::location
easy::easy
technological::technological
has::has
iso18000-6b/6a::iso18000-6b/6a
smart::smart
real::real
tests::tests
vendor::vendor
insert::insert
rules::rules
dvds::dvds
plug-ins::plug-ins
aggregation::aggregation
warehouse::warehouse
samsys::samsys
motorola::motorola
deployment::deployment
using::using
unique::unique
projects::projects
data/event::data/event
//winmec.ucla:://winmec.ucla
effectiveness::effectiveness
like::like
signal::signal
performing::performing
serves::serves
simply::simply
security::security
grouping::grouping
right::right
creation::creation
back::back
library::library
recongurable::recongurable
delivered::delivered
and/or::and/or
for::for
symbiotic::symbiotic
integration::integration
critical::critical
eliminate::eliminate
provides::provides
420::420
content::content
//www.winmec.ucla.edu/rd/:://www.winmec.ucla.edu/rd/
demonstrated::demonstrated
tdk::tdk
be::be
justication::justication
intermec::intermec
business::business
barcode::barcode
edge-of-thenetwork::edge-of-thenetwork
pressure::pressure
opticon::opticon
by::by
on::on
about::about
feig::feig
of::of
industry::industry
plaza::plaza
ean8::ean8
range::range
or::or
software::software
soa::soa
iso15693::iso15693
low-cost::low-cost
communication::communication
into::into
three::three
accommodate::accommodate
guard::guard
barcodes::barcodes
networking::networking
tis2000::tis2000
transfer::transfer
support::support
*::*
long::long
smoothing::smoothing
los::los
vendors::vendors
low::low
suit::suit
trield::trield
but::but
applicable::applicable
delivery::delivery
incorporation::incorporation
technologies::technologies
rf-dvd::rf-dvd
with::with
deployed::deployed
edge-of-the-network::edge-of-the-network
info::info
pull::pull
applying::applying
middleware::middleware
up::up
books::books
distribution::distribution
engine::engine
associated::associated
flash/mbl::flash/mbl
received::received
an::an
as::as
diverse::diverse
at::at
check::check
functions::functions
antenna::antenna
variety::variety
personnel::personnel
hybrid::hybrid
virtual::virtual
application::application
other::other
functionality::functionality
icode1::icode1
zig-bee::zig-bee
digital::digital
test::test
picture::picture
models::models
2005::2005
update::update
includes::includes
important::important
impinj::impinj
prepares::prepares
aggregated::aggregated
matrix::matrix
philips::philips
assets::assets
18000-6b::18000-6b
vice::vice
space::space
modules::modules
rule::rule
time::time
push::push
