::
limited::limited
testbeds::testbeds
//www.crewproject.eu/:://www.crewproject.eu/
consists::consists
9.56::9.56
localized::localized
calculate::calculate
under::under
worth::worth
every::every
summarized::summarized
facilities::facilities
skills::skills
~7000::~7000
solution::solution
evaluating::evaluating
estimates::estimates
direct::direct
feasibility::feasibility
second::second
7th::7th
estimated::estimated
established::established
errors::errors
hide::hide
specification::specification
above::above
new::new
nes::nes
metadata::metadata
notions::notions
automatized::automatized
equals::equals
reported::reported
granularity::granularity
obtained::obtained
k::k
anchor::anchor
procedure::procedure
complicated::complicated
mobility::mobility
explained::explained
objectively::objectively
linearly::linearly
experimentation::experimentation
nonaccuracy-related::nonaccuracy-related
would::would
hospital::hospital
therefore::therefore
type::type
until::until
m.sc::m.sc
standardized::standardized
berlin::berlin
real-time::real-time
aligned::aligned
circumstances::circumstances
springer::springer
1992::1992
room::room
1999::1999
setup::setup
work::work
mw::mw
deficiencies::deficiencies
install::install
rssi::rssi
example::example
give::give
organized::organized
tu-berlin::tu-berlin
8.31::8.31
particle-filter-based::particle-filter-based
end::end
provide::provide
feature::feature
machine::machine
how::how
methodology::methodology
abstraction::abstraction
description::description
transforming::transforming
earlier::earlier
wrong::wrong
types::types
9/3/15::9/3/15
complexity::complexity
algorithms::algorithms
first::first
order::order
executed::executed
office::office
over::over
6.7::6.7
4.39::4.39
4.35::4.35
thiemo::thiemo
crew::crew
better::better
fig::fig
encapsulates::encapsulates
then::then
them::them
combination::combination
effects::effects
they::they
represents::represents
calibrating::calibrating
each::each
side::side
mean::mean
independent::independent
series::series
principles::principles
quantile::quantile
networked::networked
network::network
uppsala::uppsala
rf::rf
infrastructure-free::infrastructure-free
telecommunication::telecommunication
standard::standard
streamline::streamline
estimate::estimate
sys::sys
over-dimensioned::over-dimensioned
created::created
messages::messages
filter::filter
iso::iso
benchmarking::benchmarking
already::already
features::features
researcher::researcher
rank::rank
deploymentsite::deploymentsite
illustrate::illustrate
annotated::annotated
service::service
1503::1503
top::top
testbed-dependent::testbed-dependent
california::california
too::too
tom::tom
toa::toa
tof::tof
ranging::ranging
tool::tool
serve::serve
took::took
post-processing::post-processing
fp7/2007-2013::fp7/2007-2013
repeatable::repeatable
distance::distance
participated::participated
project::project
enables::enables
powers::powers
mine::mine
raw::raw
manner::manner
seltzer::seltzer
latency::latency
implemented::implemented
thorough::thorough
transmit::transmit
testbeds,7::testbeds,7
web-based::web-based
hui::hui
metrics::metrics
simplify::simplify
scripts::scripts
phase::phase
ipsn::ipsn
professor::professor
m::m
points::points
tech::tech
implying::implying
attempts::attempts
7.1::7.1
radio::radio
solutions::solutions
availability::availability
lessons::lessons
layout::layout
delays::delays
wsns::wsns
rich::rich
10::10
de::de
scalable::scalable
comply::comply
unfortunately::unfortunately
fields::fields
method::method
architecture::architecture
automatic::automatic
reference::reference
testing::testing
observed::observed
depends::depends
result::result
best::best
techniques::techniques
on-demand::on-demand
away::away
artificial::artificial
score::score
approach::approach
we::we
terms::terms
omf::omf
component::component
however::however
handziski::handziski
14,282::14,282
~35.1::~35.1
improve::improve
received::received
realman06::realman06
tings::tings
wider::wider
esposito::esposito
conference::conference
basis::basis
three::three
been::been
quickly::quickly
commission::commission
interest::interest
basic::basic
expected::expected
topics::topics
facilities.1::facilities.1
rfbased::rfbased
applied::applied
6.81::6.81
publicly::publicly
n::n
near::near
suppose::suppose
//ebp.evarilos.eu/:://ebp.evarilos.eu/
characterizing::characterizing
is::is
it::it
ii::ii
conf::conf
in::in
ewsn::ewsn
if::if
grown::grown
perform::perform
things::things
make::make
cumulative::cumulative
complex::complex
lqi::lqi
pre-experimentation::pre-experimentation
several::several
european::european
evolve::evolve
hand::hand
cycle::cycle
mentioning::mentioning
whereby::whereby
scenario::scenario
1976::1976
1972::1972
academic::academic
the::the
shadowed::shadowed
proposed::proposed
universitet::universitet
assigned::assigned
identify::identify
~47.4::~47.4
visualization::visualization
eli::eli
candidate::candidate
similarities::similarities
ease::ease
ieee/acm::ieee/acm
has::has
reuse::reuse
possible::possible
ibcn::ibcn
cognitive::cognitive
performing::performing
manual::manual
unnecessary::unnecessary
comparability::comparability
specific::specific
ph.d::ph.d
steps::steps
sparse::sparse
pain::pain
fingerprinting::fingerprinting
sub-sampling::sub-sampling
for::for
bottom::bottom
icc::icc
timestamps::timestamps
ict::ict
testbed-independent::testbed-independent
repository::repository
translated::translated
architectural::architectural
properties::properties
magazine::magazine
iminds::iminds
efforts::efforts
runtime::runtime
automatically::automatically
considerations::considerations
presence::presence
obtaining::obtaining
accommodate::accommodate
raises::raises
0.83::0.83
support::support
resulted::resulted
was::was
lowest::lowest
wireless::wireless
maximum::maximum
devices::devices
simplifying::simplifying
19.31::19.31
computing::computing
abstract::abstract
proven::proven
expertise::expertise
physical::physical
6.93::6.93
no::no
whereas::whereas
generally::generally
conditions::conditions
role::role
papers::papers
test::test
developers::developers
node::node
models::models
update::update
scores::scores
packets::packets
together::together
reception::reception
time::time
concept::concept
focus::focus
leads::leads
computation::computation
chair::chair
rectangles::rectangles
environment::environment
0::0
finally::finally
indoor::indoor
frequencies::frequencies
industrial-like::industrial-like
1993::1993
8.63::8.63
exact::exact
icl-gnss15::icl-gnss15
presented::presented
p::p
environment-specific::environment-specific
prevent::prevent
cost::cost
~500::~500
current::current
international::international
supporting::supporting
ms::ms
downloaded::downloaded
address::address
based::based
institute::institute
studies::studies
adjustable::adjustable
useful::useful
chaired::chaired
prefer::prefer
should::should
working::working
daad::daad
by::by
scenarios::scenarios
criteria::criteria
scope::scope
theoretical::theoretical
wksps::wksps
acceptable::acceptable
effort::effort
organizations::organizations
modified::modified
reviews::reviews
317989::317989
values::values
can::can
growing::growing
trans::trans
usability::usability
dedicated::dedicated
figure::figure
performed::performed
hides::hides
swedish::swedish
requirements::requirements
divided::divided
1::1
,5::,5
net/projects/omf6/wiki/::net/projects/omf6/wiki/
optimal::optimal
parameter::parameter
may::may
max::max
fed::fed
applications::applications
explored::explored
designed::designed
0.75::0.75
improving::improving
such::such
data::data
man::man
ss::ss
fp7::fp7
so::so
sc::sc
typical::typical
serving::serving
subsections::subsections
haute::haute
years::years
course::course
experiments::experiments
statistical::statistical
still::still
ieee::ieee
group::group
facility::facility
hot::hot
coordinates::coordinates
platform::platform
offers::offers
main::main
5.56::5.56
thereby::thereby
introduce::introduce
not::not
26.7::26.7
now::now
parallelograms::parallelograms
matched::matched
repositories::repositories
realistic::realistic
weighted::weighted
significantly::significantly
trade-offs::trade-offs
ed::ed
challenges::challenges
et::et
summary::summary
adequately::adequately
predefined::predefined
shown::shown
space::space
furthermore::furthermore
interference::interference
upinlbs14::upinlbs14
investigation::investigation
internet::internet
sensor::sensor
correct::correct
she::she
after::after
seventh::seventh
possibility::possibility
advantages::advantages
advance::advance
training::training
programming::programming
tries::tries
motion::motion
flanders::flanders
promotion::promotion
1000::1000
omitted::omitted
one::one
cybernetics::cybernetics
specifically::specifically
directly::directly
open::open
given::given
necessarily::necessarily
structured::structured
remotely::remotely
2::2
structures::structures
gives::gives
that::that
accurately::accurately
than::than
11::11
wide::wide
13::13
12::12
15::15
14::14
17::17
16::16
19::19
future::future
were::were
accessed::accessed
outcome::outcome
and::and
pro::pro
locations::locations
distorted::distorted
any::any
conversion::conversion
iso/iec::iso/iec
efficient::efficient
note::note
emphasis::emphasis
take::take
online::online
objective::objective
performance::performance
multiple::multiple
considered::considered
average::average
later::later
senior::senior
typically::typically
precise::precise
show::show
german::german
ground::ground
behind::behind
only::only
awareness::awareness
non-rf-based::non-rf-based
30.00::30.00
secondary::secondary
resource::resource
settings::settings
13.45::13.45
median::median
requesting::requesting
where::where
16th::16th
fails::fails
iwt-vlaanderen::iwt-vlaanderen
sites::sites
3::3
between::between
reproducible::reproducible
across::across
jtc::jtc
arrival::arrival
infrastructure::infrastructure
comp::comp
awards::awards
article::article
installation::installation
summa::summa
many::many
propagation::propagation
s::s
wirstrm::wirstrm
executables::executables
among::among
overview::overview
60::60
learning::learning
writing::writing
considering::considering
locally::locally
combined::combined
engine::engine
enable::enable
offered::offered
observe::observe
external::external
those::those
case::case
gliwice::gliwice
these::these
single::single
situation::situation
conferences::conferences
characteristics::characteristics
metric::metric
middle::middle
technology::technology
binary::binary
different::different
develop::develop
interdisciplinary::interdisciplinary
author::author
802.15.4::802.15.4
same::same
events::events
assist::assist
director::director
running::running
changing::changing
implements::implements
tracking::tracking
without::without
ficco::ficco
components::components
very::very
researchers::researchers
scholarship::scholarship
imental::imental
being::being
when::when
rest::rest
captured::captured
doctoral::doctoral
26.67::26.67
//www.ictfire.eu/home.html:://www.ictfire.eu/home.html
parametrization::parametrization
interested::interested
4::4
samples::samples
scheduled::scheduled
aspects::aspects
voigt::voigt
using::using
execution::execution
particle::particle
intec::intec
serves::serves
server::server
t::t
output::output
stationary::stationary
6.68::6.68
competition::competition
calculated::calculated
table::table
matching::matching
provided::provided
0163-6804/15/::0163-6804/15/
extensively::extensively
provides::provides
refer::refer
measuring::measuring
biased::biased
dresden::dresden
scientific::scientific
industriallike::industriallike
ingrid::ingrid
inherent::inherent
manufacturer::manufacturer
acc::acc
on::on
chintalapudi::chintalapudi
ack::ack
of::of
industry::industry
discussed::discussed
acm::acm
estimator::estimator
or::or
op::op
beacons::beacons
communication::communication
references::references
determine::determine
theoretically::theoretically
her::her
area::area
removing::removing
there::there
los::los
low::low
//mytestbed.net/:://mytestbed.net/
methodologies::methodologies
technologies::technologies
trying::trying
visualizers::visualizers
datasets::datasets
embedded::embedded
default::default
18.93::18.93
robustness::robustness
detailed::detailed
certain::certain
describe::describe
al::al
fellow::fellow
as::as
scanned::scanned
at::at
wolisz::wolisz
corresponding::corresponding
again::again
4.6::4.6
drafts::drafts
hybrid::hybrid
5::5
spatial::spatial
includes::includes
important::important
suited::suited
range-free::range-free
480::480
building::building
remote::remote
5:43::5:43
wifi::wifi
adam::adam
represent::represent
all::all
sci::sci
consider::consider
lack::lack
executing::executing
range-based::range-based
tx::tx
tu::tu
to::to
program::program
protocols::protocols
nodes::nodes
activities::activities
far::far
time-offlight::time-offlight
electrotechnical::electrotechnical
issue::issue
joined::joined
adjust::adjust
plugins::plugins
further::further
openspace::openspace
section::section
sut::sut
learned::learned
public::public
full::full
14,285::14,285
modify::modify
6.70::6.70
beacon::beacon
operating::operating
berkeley::berkeley
fwo::fwo
vlado::vlado
allows::allows
experience::experience
published::published
options::options
preconfigured::preconfigured
analyzing::analyzing
sensors::sensors
select::select
contains::contains
two::two
0.82::0.82
comparing::comparing
0.80::0.80
6::6
taken::taken
more::more
particular::particular
known::known
none::none
science::science
v::v
wksp::wksp
compare::compare
radiomap::radiomap
states::states
minimum::minimum
information::information
needs::needs
rather::rather
influences::influences
mermat::mermat
long::long
poorter::poorter
faculty::faculty
response::response
a::a
shortcomings::shortcomings
misra::misra
help::help
september::september
developed::developed
installed::installed
through::through
committee::committee
its::its
20::20
22::22
23::23
handheld::handheld
filip::filip
systems::systems
finer::finer
~105::~105
motivated::motivated
propose::propose
7.08::7.08
framework::framework
walls::walls
communities::communities
easily::easily
fully::fully
truths::truths
capability::capability
found::found
weight::weight
generation::generation
energy::energy
hard::hard
idea::idea
obtains::obtains
measurement::measurement
45.00::45.00
funding::funding
since::since
viability::viability
research::research
7::7
offline::offline
evaluation::evaluation
localization::localization
diploma::diploma
generate::generate
definition::definition
benefits::benefits
e.g::e.g
positioning::positioning
technische::technische
exponentially::exponentially
w::w
major::major
utilizes::utilizes
probability::probability
upper::upper
number::number
done::done
utilization::utilization
introduction::introduction
leading::leading
wilab.t::wilab.t
lemic::lemic
option::option
preexperimentation::preexperimentation
part::part
authors::authors
niklas::niklas
aal::aal
systems.2::systems.2
depending::depending
liu::liu
costs::costs
aliasing::aliasing
eff::eff
18305::18305
measures::measures
most::most
experiences::experiences
significant::significant
comparisons::comparisons
services::services
infrastructures::infrastructures
measured::measured
85.0::85.0
tpc::tpc
mobile::mobile
clear::clear
part-time::part-time
microsoft::microsoft
cdf::cdf
lymberopoulos::lymberopoulos
networks::networks
cell::cell
indicator::indicator
parameters::parameters
distributed::distributed
8::8
iec::iec
his::his
evarilos::evarilos
competing::competing
struc::struc
during::during
tkn-14-002::tkn-14-002
tkn-14-003::tkn-14-003
tkn-14-001::tkn-14-001
stored::stored
common::common
set::set
individual::individual
are::are
2.2::2.2
2.0::2.0
deploying::deploying
visualize::visualize
currently::currently
unions::unions
plywood::plywood
numerous::numerous
available::available
recently::recently
creating::creating
interfaces::interfaces
scalability::scalability
spray::spray
ranked::ranked
interface::interface
both::both
c::c
last::last
improves::improves
context::context
olisz::olisz
reply::reply
whole::whole
experimental::experimental
point::point
simple::simple
community::community
mentioninteraction::mentioninteraction
ghent::ghent
expensive::expensive
consuming::consuming
described::described
acceptance::acceptance
due::due
describes::describes
collected::collected
combine::combine
ph::ph
pm::pm
generating::generating
fire::fire
precision::precision
representative::representative
evaluated::evaluated
technical::technical
while::while
bachelors::bachelors
behavior::behavior
error::error
real::real
vol::vol
grant::grant
wherein::wherein
9::9
development::development
used::used
comprehensive::comprehensive
triangulation::triangulation
strength::strength
uses::uses
user::user
standardization/international::standardization/international
recent::recent
task::task
database::database
navigation::navigation
poland::poland
analysis::analysis
flags::flags
organization::organization
distances::distances
ugent.be::ugent.be
methodius::methodius
competitive::competitive
project3::project3
$::$
also::also
source::source
location::location
input::input
cum::cum
format::format
evaluate::evaluate
showing::showing
plug-ins::plug-ins
testbeds,6::testbeds,6
projects::projects
modifications::modifications
d::d
systematically::systematically
follows::follows
signal::signal
communications::communications
popular::popular
methods::methods
creation::creation
some::some
instantiating::instantiating
examples::examples
sight::sight
and/or::and/or
describing::describing
measurements::measurements
integration::integration
per::per
competitions::competitions
innovation::innovation
proc::proc
either::either
be::be
run::run
processing::processing
agreement::agreement
step::step
4.63::4.63
optimize::optimize
silesian::silesian
range::range
//omf.mytestbed:://omf.mytestbed
consequently::consequently
80.0::80.0
intl::intl
into::into
within::within
servers::servers
appropriate::appropriate
statistics::statistics
few::few
extremely::extremely
fast::fast
custom::custom
handbook::handbook
analyze::analyze
files::files
considerably::considerably
an::an
link::link
line::line
junior::junior
deployed::deployed
info::info
open-space::open-space
up::up
autonomous::autonomous
called::called
storing::storing
associated::associated
defined::defined
influence::influence
accessibility::accessibility
engineering::engineering
%::%
application::application
electrical::electrical
department::department
users::users
problems::problems
generated::generated
allowing::allowing
structure::structure
correlated::correlated
e::e
algorithm::algorithm
required::required
2002::2002
2000::2000
2006::2006
2007::2007
requires::requires
receive::receive
initiating::initiating
once::once
illustrates::illustrates
//evaal.aaloa.org:://evaal.aaloa.org
results::results
existing::existing
illustrated::illustrated
strep::strep
contributions::contributions
issues::issues
www.ibcn.intec::www.ibcn.intec
include::include
friendly::friendly
sent::sent
categories::categories
transmission::transmission
integrating::integrating
configurations::configurations
application-specific::application-specific
download::download
vided::vided
flagship::flagship
person/object::person/object
power::power
multimedia::multimedia
access::access
experiment::experiment
;::;
proliferation::proliferation
degree::degree
exchange::exchange
leveraging::leveraging
following::following
focused::focused
cyber-physical::cyber-physical
others::others
consideration::consideration
biographies::biographies
31::31
37::37
survey::survey
postprocessing::postprocessing
implement::implement
makes::makes
involves::involves
addresses::addresses
aps::aps
wirstrom::wirstrom
wik::wik
api::api
tools::tools
cloud::cloud
use::use
from::from
consumption::consumption
next::next
calculation::calculation
optimizing::optimizing
upcoming::upcoming
comparison::comparison
inclined::inclined
purposes::purposes
train::train
account::account
f::f
this::this
challenge::challenge
publications::publications
control::control
0.8::0.8
proprietary::proprietary
process::process
0.0::0.0
0.2::0.2
0.4::0.4
0.6::0.6
high::high
delay::delay
~30.9::~30.9
specifications::specifications
collection::collection
monitoring::monitoring
efficiently::efficiently
precollected::precollected
correspond::correspond
subsequently::subsequently
insight::insight
meter::meter
produced::produced
132::132
131::131
130::130
including::including
mentioned::mentioned
temporal::temporal
degrees::degrees
choose::choose
2015::2015
2014::2014
sensys::sensys
2011::2011
2010::2010
2013::2013
2012::2012
richness::richness
dam::dam
fingerprint::fingerprint
day::day
masters::masters
universitt::universitt
university::university
identified::identified
truth::truth
traces::traces
related::related
bluetooth::bluetooth
frequency::frequency
calibrate::calibrate
measure::measure
our::our
out::out
acknowledgment::acknowledgment
rep::rep
integrated::integrated
workflow::workflow
approaches::approaches
~35,000::~35,000
van::van
moerman::moerman
1983::1983
interaction::interaction
could::could
times::times
facilitate::facilitate
third::third
proposing::proposing
quality::quality
management::management
start::start
system::system
their::their
1507::1507
final::final
scans::scans
interests::interests
configure::configure
exactly::exactly
environmental::environmental
bouckaert::bouckaert
w-ilab::w-ilab
sweden::sweden
orchestrated::orchestrated
providing::providing
cochair::cochair
descriptions::descriptions
1.0::1.0
have::have
need::need
constrained::constrained
min::min
//www.iso.org:://www.iso.org
adjunct::adjunct
which::which
habil::habil
=::=
accuracy::accuracy
deploy::deploy
who::who
skopje::skopje
device::device
intrinsic::intrinsic
gather::gather
request::request
17.52::17.52
internet-based::internet-based
fact::fact
supported::supported
tures::tures
postdoctoral::postdoctoral
staff::staff
cyril::cyril
with::with
operational::operational
partially::partially
local::local
overall::overall
joint::joint
interoperability::interoperability
126::126
127::127
128::128
129::129
predeployed::predeployed
projects/omf/wiki/::projects/omf/wiki/
areas::areas
133::133
h::h
non-functional::non-functional
processed::processed
rf-based::rf-based
contain::contain
fixed::fixed
pertains::pertains
view::view
requirement::requirement
configured::configured
ebh::ebh
packet::packet
edition::edition
computer::computer
ebp::ebp
exper::exper
phases::phases
state::state
identification::identification
comparable::comparable
efficiency::efficiency
configuration::configuration
optional::optional
problem::problem
etc::etc
estimation::estimation
non-ebp-compliant::non-ebp-compliant
otherwise::otherwise
strongly::strongly
relevant::relevant
conclude::conclude
wall::wall
environments::environments
testbed-specific::testbed-specific
respect::respect
addition::addition
evaal::evaal
indicators::indicators
utilizing::utilizing
define::define
controlled::controlled
460::460
finished::finished
general::general
present::present
twist::twist
smartphones::smartphones
laser::laser
value::value
will::will
layer::layer
manually::manually
thus::thus
hardware::hardware
vs::vs
sequentially::sequentially
generic::generic
zagreb::zagreb
member::member
became::became
underground::underground
http::http
upon::upon
effect::effect
automation::automation
architectures::architectures
student::student
robotic::robotic
i::i
well::well
patterns::patterns
position::position
10.20::10.20
stores::stores
proximity::proximity
executive::executive
sources::sources
interim::interim
testbed::testbed
w-ilab.t::w-ilab.t
low-level::low-level
web::web
large-scale::large-scale
capabilities::capabilities
cdfs::cdfs
usage::usage
deployment::deployment
belgium::belgium
necessary::necessary
suts::suts
fingerprints::fingerprints
martin::martin
setups::setups
page::page
accessible::accessible
transport::transport
demonstrates::demonstrates
reconfigurable::reconfigurable
does::does
leverages::leverages
demonstrated::demonstrated
although::although
about::about
actual::actual
software::software
own::own
previously::previously
functional::functional
dataset::dataset
vanhaute_layout.qxp_author::vanhaute_layout.qxp_author
included::included
1987::1987
networking::networking
additional::additional
rssi-values::rssi-values
function::function
but::but
automated::automated
brick::brick
he::he
made::made
cells::cells
official::official
below::below
demonstrate::demonstrate
distribution::distribution
recognize::recognize
multimodal::multimodal
ing::ing
compared::compared
variety::variety
detail::detail
sics::sics
other::other
compares::compares
details::details
conclusion::conclusion
additionally::additionally
25.00::25.00
laude::laude
factors::factors
experimenters::experimenters
validation::validation
