::
limited::limited
secondly::secondly
inadequacy::inadequacy
magnetic::magnetic
desirable::desirable
monte::monte
four::four
consists::consists
saved::saved
relationships::relationships
279284::279284
deploying::deploying
presents::presents
fine-grained::fine-grained
under::under
cm1::cm1
@::@
updated::updated
dynamic::dynamic
escudero::escudero
probability::probability
every::every
updates::updates
casas::casas
affect::affect
electronics::electronics
mehmood::mehmood
school::school
6790::6790
fdma::fdma
supports::supports
solution::solution
vector::vector
markov::markov
falco::falco
phones::phones
consistent::consistent
estimates::estimates
pulse::pulse
feasibility::feasibility
surrounding::surrounding
second::second
7th::7th
reengineering::reengineering
estimated::estimated
even::even
errors::errors
integrity::integrity
selected::selected
asia::asia
cheng::cheng
new::new
net::net
increasing::increasing
simultaneously::simultaneously
reported::reported
active::active
path::path
100::100
logarithmic::logarithmic
obtained::obtained
/time::/time
k::k
techiques::techiques
changes::changes
projection::projection
classification::classification
mobility::mobility
highly::highly
visible::visible
modulated::modulated
achievable::achievable
unit::unit
would::would
motivate::motivate
m5::m5
m4::m4
music::music
asset::asset
m3::m3
m2::m2
type::type
garca::garca
arraytrack::arraytrack
phone::phone
holm::holm
real-time::real-time
must::must
me::me
springer::springer
room::room
mc::mc
permits::permits
mm::mm
setup::setup
work::work
era::era
wlans::wlans
niemegeers::niemegeers
rssi::rssi
hansen::hansen
example::example
802.112007::802.112007
cited::cited
calibration::calibration
amplitudes::amplitudes
absolute::absolute
end::end
hoc::hoc
provide::provide
feature::feature
multi-path::multi-path
machine::machine
how::how
symposium::symposium
widespread::widespread
description::description
after::after
fiducials::fiducials
m-2::m-2
diagram::diagram
306310::306310
modest::modest
lap::lap
types::types
zigbee-based::zigbee-based
wknn::wknn
stand-alone::stand-alone
complexity::complexity
maintain::maintain
algorithms::algorithms
correlation::correlation
order::order
wind::wind
operations::operations
feedback::feedback
office::office
over::over
vary::vary
fifs::fifs
innovative::innovative
283302::283302
mabed::mabed
directional::directional
personal::personal
fix::fix
better::better
complex::complex
hidden::hidden
versus::versus
then::then
them::them
affected::affected
combination::combination
lambert::lambert
band::band
effects::effects
they::they
comprised::comprised
bakhsh::bakhsh
mcmc::mcmc
classified::classified
l::l
580585::580585
each::each
cybernetics::cybernetics
mean::mean
schemes::schemes
financial::financial
principles::principles
commons::commons
literature::literature
combining::combining
dowoo::dowoo
goo::goo
network::network
realtime::realtime
content::content
rf::rf
adapt::adapt
gutierrez::gutierrez
reader::reader
medicine::medicine
802.11gwith::802.11gwith
xu::xu
telecommunication::telecommunication
little::little
standard::standard
245::245
corrects::corrects
estimate::estimate
non-line-of-sight::non-line-of-sight
privacy::privacy
map-matching::map-matching
filter::filter
ism::ism
moving::moving
speeds::speeds
purpose::purpose
industrial::industrial
features::features
channels::channels
another::another
electronic::electronic
xia::xia
service::service
needed::needed
too::too
milligan::milligan
toa::toa
tof::tof
ranging::ranging
urban::urban
tat-chee::tat-chee
distance::distance
ahmed::ahmed
target::target
enabled::enabled
historical::historical
acoustics::acoustics
contribution::contribution
enables::enables
lbs::lbs
modern::modern
raw::raw
latency::latency
strength::strength
cope::cope
client::client
doors::doors
effectiveness::effectiveness
gualda::gualda
though::though
object::object
metrics::metrics
y::y
plenty::plenty
phase::phase
futuretech::futuretech
/nonlineby::/nonlineby
assisting::assisting
observation::observation
calculated::calculated
m::m
points::points
signatures::signatures
precarious::precarious
infrared::infrared
radio::radio
solutions::solutions
wiebking::wiebking
availability::availability
proposed::proposed
implementation::implementation
guidance::guidance
topological::topological
theme::theme
signal-related::signal-related
do::do
10::10
scalable::scalable
dr::dr
unfortunately::unfortunately
runs::runs
off-theshelf::off-theshelf
covering::covering
timebased::timebased
acknowledgments::acknowledgments
mayora::mayora
automatic::automatic
reference::reference
sensitivity::sensitivity
detection::detection
depends::depends
result::result
fail::fail
best::best
techniques::techniques
03::03
capacity::capacity
07::07
05::05
08::08
09::09
artificial::artificial
unable::unable
simplest::simplest
propagated::propagated
approach::approach
combain::combain
discovery::discovery
systech::systech
we::we
terms::terms
amplitude::amplitude
nature::nature
weak::weak
however::however
wu::wu
extent::extent
modeling::modeling
improve::improve
suggested::suggested
received::received
uncertainty::uncertainty
against::against
ils::ils
receiver::receiver
requests::requests
gezici::gezici
coo::coo
subscribing::subscribing
trust::trust
telecommunications::telecommunications
conference::conference
billing::billing
basis::basis
three::three
been::been
quickly::quickly
interest::interest
basic::basic
tutorials::tutorials
graphical::graphical
hoene::hoene
lifs::lifs
rfbased::rfbased
worked::worked
applied::applied
publicly::publicly
baunach::baunach
n::n
property::property
anchor::anchor
procedure::procedure
is::is
ir::ir
it::it
iv::iv
ii::ii
in::in
id::id
if::if
urena::urena
perform::perform
cumulative::cumulative
amount::amount
beside::beside
drawback::drawback
advances::advances
several::several
grows::grows
european::european
fairly::fairly
satellite::satellite
horus::horus
cell-id::cell-id
nlos::nlos
1600::1600
academic::academic
contact::contact
the::the
joon::joon
aoa-based::aoa-based
bandwidth::bandwidth
identify::identify
transforms::transforms
human::human
yes::yes
previous::previous
adding::adding
vibration::vibration
ease::ease
passive::passive
spread::spread
easy::easy
technological::technological
has::has
reuse::reuse
bands::bands
possible::possible
rahman::rahman
unique::unique
advanced::advanced
multiplexing::multiplexing
54::54
manual::manual
unnecessary::unnecessary
specific::specific
steps::steps
security::security
smart-phone::smart-phone
right::right
people::people
sends::sends
51::51
dead::dead
malaysia::malaysia
meters::meters
fingerprinting::fingerprinting
for::for
collect::collect
electromagnetic::electromagnetic
creative::creative
ubiquity::ubiquity
timestamps::timestamps
geocoding::geocoding
participation::participation
core::core
algorithmic::algorithmic
properties::properties
bahl::bahl
limitation::limitation
mohapatra::mohapatra
months::months
o::o
efforts::efforts
slightly::slightly
placeengine::placeengine
presence::presence
civil::civil
obtaining::obtaining
lies::lies
beings::beings
bats::bats
balanced::balanced
korenberg::korenberg
osmani::osmani
support::support
initial::initial
sunlight::sunlight
accuracy/precision::accuracy/precision
editor::editor
way::way
researchers::researchers
was::was
therefore::therefore
medium::medium
offering::offering
offer::offer
becoming::becoming
18th::18th
wireless::wireless
builds::builds
arrays::arrays
inside::inside
trends::trends
devices::devices
sopenbmap::sopenbmap
computing::computing
covers::covers
exist::exist
perez::perez
distributions::distributions
trip::trip
triangles::triangles
physical::physical
ni::ni
marking::marking
gracia::gracia
no::no
whereas::whereas
when::when
reality::reality
interested::interested
holding::holding
test::test
developers::developers
node::node
models::models
chiang::chiang
spects::spects
interval::interval
modules::modules
3.2.1::3.2.1
3.2.2::3.2.2
3.2.3::3.2.3
neighbors::neighbors
concept::concept
chain::chain
reviewers::reviewers
global::global
focus::focus
multi-floor::multi-floor
computation::computation
21st::21st
depend::depend
desired/specified::desired/specified
technique::technique
environment::environment
0::0
finally::finally
division::division
smartphone::smartphone
broadly::broadly
zhang::zhang
frequencies::frequencies
wifi-based::wifi-based
anonymous::anonymous
short-range::short-range
solves::solves
presented::presented
p::p
subway::subway
trustcom::trustcom
round::round
prevent::prevent
says::says
attia::attia
prediction::prediction
cost::cost
substitute::substitute
spectral::spectral
current::current
time-consuming::time-consuming
unrestricted::unrestricted
transportation::transportation
shankar::shankar
mahamod::mahamod
understanding::understanding
corporation::corporation
address::address
along::along
change::change
box::box
ref::ref
75987601::75987601
studied::studied
wherever::wherever
bangi::bangi
zirazi::zirazi
ineffective::ineffective
throughput::throughput
usually::usually
navigation::navigation
inference::inference
extra::extra
marked::marked
electromagnetics::electromagnetics
1st::1st
should::should
market::market
cnsi::cnsi
working::working
scenarios::scenarios
distance-based::distance-based
criteria::criteria
s.-h::s.-h
theoretical::theoretical
today::today
distribution::distribution
everywhere::everywhere
degrade::degrade
location-awareness::location-awareness
inertial::inertial
zhao::zhao
values::values
can::can
following::following
location-based::location-based
nearest::nearest
dedicated::dedicated
figure::figure
december::december
performed::performed
occur::occur
requirements::requirements
divided::divided
trilateration::trilateration
1::1
vital::vital
optimal::optimal
parameter::parameter
map::map
mar::mar
aoa::aoa
influenced::influenced
may::may
spot::spot
multiple-input::multiple-input
applications::applications
4th::4th
designed::designed
such::such
data::data
man::man
long-range::long-range
6th::6th
sq::sq
ghz::ghz
so::so
april::april
omer::omer
typical::typical
serving::serving
glanzer::glanzer
mainly::mainly
icccn::icccn
unsuitable::unsuitable
motions::motions
multipath::multipath
ieee::ieee
noncontact::noncontact
derive::derive
thank::thank
coordinates::coordinates
decreased::decreased
main::main
correspondence::correspondence
views::views
not::not
reckoning::reckoning
nor::nor
name::name
january::january
h::h
entirely::entirely
domain::domain
weighted::weighted
significantly::significantly
darabi::darabi
ft::ft
gaussian::gaussian
selangor::selangor
challenges::challenges
ieee/ion::ieee/ion
et::et
predefined::predefined
shown::shown
3rd::3rd
space::space
furthermore::furthermore
interference::interference
increase::increase
investigation::investigation
775784::775784
receiving::receiving
sensor::sensor
correct::correct
theory::theory
cars::cars
spies::spies
advantages::advantages
besides::besides
wi-fi::wi-fi
mimo::mimo
training::training
ministry::ministry
where::where
programming::programming
motion::motion
place::place
toa/rtof::toa/rtof
first::first
origin::origin
wlan::wlan
coming::coming
symbolic::symbolic
one::one
simplified::simplified
directly::directly
carry::carry
open::open
angular::angular
size::size
surveys::surveys
ofdm::ofdm
breed::breed
mobicom::mobicom
response::response
households::households
ukm::ukm
2::2
cost-effective::cost-effective
structures::structures
mostly::mostly
that::that
accurately::accurately
zahidf9::zahidf9
clients::clients
than::than
11::11
wide::wide
13::13
12::12
15::15
14::14
17::17
16::16
19::19
18::18
require::require
future::future
cards::cards
and::and
dynamically::dynamically
locations::locations
802.11n::802.11n
exchanging::exchanging
any::any
efficient::efficient
connell::connell
ideas::ideas
equipment::equipment
potential::potential
online::online
performance::performance
strengths::strengths
channel::channel
multiple::multiple
normal::normal
falls::falls
icisa::icisa
remarks::remarks
analytically::analytically
pages::pages
mbit/s::mbit/s
especially::especially
diversity::diversity
average::average
sohn::sohn
/round-trip::/round-trip
duplication::duplication
typically::typically
precise::precise
show::show
slow::slow
only::only
implemented::implemented
developed::developed
frequency-division::frequency-division
get::get
samuel::samuel
designated::designated
conjunction::conjunction
manuscripts::manuscripts
median::median
tdoa::tdoa
cartography::cartography
predicted::predicted
unlicensed::unlicensed
attenuated::attenuated
maximum::maximum
relative::relative
asleep::asleep
fails::fails
ways::ways
review::review
3::3
lbss::lbss
between::between
geometric::geometric
icpwc::icpwc
across::across
arrival::arrival
infrastructure::infrastructure
august::august
receivers::receivers
gnss::gnss
analyzed::analyzed
article::article
come::come
mastela::mastela
installation::installation
many::many
region::region
trace-back::trace-back
propagation::propagation
s::s
nearby::nearby
among::among
filtering::filtering
information-theoretic::information-theoretic
robotics::robotics
bekele::bekele
period::period
sampling::sampling
64::64
65::65
moreover::moreover
combines::combines
marc::marc
detected::detected
workshop::workshop
combined::combined
malpani::malpani
1030::1030
direction::direction
shopping::shopping
influence::influence
offered::offered
bayesian::bayesian
case::case
these::these
single::single
hayes::hayes
geodetic::geodetic
transactions::transactions
promising::promising
coupled::coupled
characteristics::characteristics
metric::metric
strain::strain
ambient::ambient
technology::technology
multiple-output::multiple-output
movements::movements
different::different
author::author
same::same
acis/jnu::acis/jnu
runge::runge
pai::pai
barral::barral
disadvantages::disadvantages
rfid::rfid
persons::persons
running::running
wired::wired
el-sheimy::el-sheimy
totally::totally
tracking::tracking
floor::floor
observations::observations
without::without
components::components
coordinate::coordinate
model::model
dimension::dimension
bodies::bodies
outdoor::outdoor
being::being
money::money
valuable::valuable
speed::speed
generator::generator
prieto::prieto
improvement::improvement
4::4
disrupt::disrupt
real::real
aspects::aspects
around::around
warehouse::warehouse
grid::grid
darl::darl
using::using
accepted::accepted
suma::suma
furniture::furniture
achieve::achieve
reduces::reduces
server::server
benefit::benefit
either::either
fully::fully
pereira::pereira
stationary::stationary
reduced::reduced
wbi::wbi
specifies::specifies
cisco::cisco
zigbee::zigbee
draw::draw
shortcoming::shortcoming
respect::respect
sommer::sommer
matching::matching
provided::provided
dimensions::dimensions
recorded::recorded
6269::6269
provides::provides
provider::provider
914::914
necessitating::necessitating
refer::refer
measuring::measuring
assembly::assembly
scientific::scientific
power::power
self-calibration::self-calibration
padmanabhan::padmanabhan
popleteev::popleteev
refers::refers
comparison::comparison
stations::stations
of::of
industry::industry
discussed::discussed
acm::acm
singapoore::singapoore
mixed::mixed
os::os
or::or
road::road
beacons::beacons
communication::communication
image::image
low-power::low-power
references::references
determine::determine
your::your
intervention::intervention
log::log
area::area
there::there
los::los
low::low
lot::lot
farid::farid
kolla::kolla
recommends::recommends
displacement::displacement
suffers::suffers
agrawala::agrawala
uwb-based::uwb-based
technologies::technologies
xtify::xtify
with::with
arranged::arranged
embedded::embedded
required::required
ad::ad
//dx.doi.org/10.1155/2013/185138:://dx.doi.org/10.1155/2013/185138
certain::certain
al::al
general::general
ap::ap
as::as
reliability::reliability
at::at
lifetime::lifetime
hospitals::hospitals
high-bandwidth::high-bandwidth
4.1::4.1
antenna::antenna
4.2::4.2
hybrid::hybrid
field::field
5::5
spatial::spatial
2007::2007
deviation::deviation
tripathi::tripathi
separate::separate
time::time
includes::includes
important::important
suited::suited
building::building
remote::remote
assets::assets
wifi::wifi
curve::curve
u::u
starting::starting
original::original
represent::represent
all::all
ismail::ismail
cooperative::cooperative
responsiveness::responsiveness
tv::tv
opportunities::opportunities
to::to
ultrawideband::ultrawideband
rtof::rtof
nodes::nodes
outdoor/indoor::outdoor/indoor
sound::sound
recalculation::recalculation
attribution::attribution
jensen::jensen
very::very
resistance::resistance
novel::novel
uwb::uwb
difference::difference
christmann::christmann
stimulus::stimulus
evaluation::evaluation
large::large
small::small
rate::rate
design::design
quebec::quebec
pass::pass
further::further
wbi-based::wbi-based
nonlinear::nonlinear
section::section
optoelectronics::optoelectronics
ipin::ipin
method::method
movement::movement
ultralow-power::ultralow-power
installations::installations
tags::tags
component::component
ranges::ranges
beacon::beacon
november::november
strong::strong
subcarrier::subcarrier
experience::experience
prior::prior
airport::airport
43600::43600
narrow::narrow
via::via
requiring::requiring
indoors::indoors
appliances::appliances
sensors::sensors
iglesias::iglesias
conventional::conventional
wlan-based::wlan-based
takes::takes
vlsi::vlsi
two::two
comparing::comparing
archives::archives
6::6
taken::taken
markets::markets
more::more
israel::israel
tested::tested
state-ofthe-art::state-ofthe-art
basically::basically
particular::particular
known::known
none::none
science::science
installing::installing
noland::noland
mall::mall
v::v
strategies::strategies
specialized::specialized
compare::compare
synchronized::synchronized
scan::scan
collision::collision
numbers::numbers
arise::arise
information::information
needs::needs
yiming::yiming
strongest::strongest
advantage::advantage
permissive::permissive
maps::maps
centimeters::centimeters
ibrahim::ibrahim
ubiquitous::ubiquitous
plans::plans
weaknesses::weaknesses
connectivity::connectivity
plane::plane
waves::waves
invasion::invasion
293296::293296
fm::fm
a::a
short::short
seco::seco
help::help
september::september
taxonomy::taxonomy
moussa::moussa
radar::radar
paper::paper
through::through
minmax::minmax
its::its
24::24
25::25
26::26
27::27
20::20
21::21
22::22
23::23
susceptible::susceptible
pcs::pcs
boud::boud
28::28
29::29
handheld::handheld
absence::absence
systems::systems
standards802.11a::standards802.11a
pca::pca
yi::yi
rozyyev::rozyyev
good::good
abouttechnology/zigbeetechnology.aspx::abouttechnology/zigbeetechnology.aspx
reflected::reflected
underground::underground
walls::walls
easily::easily
always::always
level::level
20002007::20002007
2d::2d
pknn::pknn
found::found
//en.wikipedia.org/wiki/global:://en.wikipedia.org/wiki/global
heavy::heavy
reactions::reactions
shock::shock
weight::weight
energy::energy
reduce::reduce
used::used
carvalho::carvalho
undertake::undertake
measurement::measurement
ultra-wideband::ultra-wideband
4043::4043
angulation::angulation
research::research
7::7
offline::offline
issue::issue
localization::localization
reason::reason
base::base
put::put
pairs::pairs
benefits::benefits
e.g::e.g
computers::computers
positioning::positioning
exponentially::exponentially
w::w
investigates::investigates
major::major
forwards::forwards
number::number
well-known::well-known
utilized::utilized
done::done
construct::construct
17761781::17761781
introduction::introduction
automobile::automobile
5th::5th
least::least
station::station
scheme::scheme
gpr::gpr
gps::gps
canalda::canalda
part::part
signaling::signaling
authors::authors
b::b
determines::determines
aims::aims
recording::recording
determined::determined
supposed::supposed
outdoors::outdoors
modeled::modeled
ages::ages
pedestrian::pedestrian
categorized::categorized
vulnerable::vulnerable
paths::paths
depending::depending
lim::lim
lin::lin
majority::majority
empirically::empirically
costs::costs
square::square
build::build
finding::finding
towards::towards
measures::measures
most::most
plan::plan
significant::significant
position::position
services::services
infrastructures::infrastructures
extremely::extremely
subhan::subhan
mobile::mobile
sometimes::sometimes
traditional::traditional
chemical::chemical
optical::optical
reflections::reflections
velocity::velocity
microsoft::microsoft
particularly::particularly
scattered::scattered
rtt::rtt
networks::networks
cell::cell
indicator::indicator
copyright::copyright
less::less
distributed::distributed
transmitting::transmitting
factor::factor
8::8
accurate::accurate
dominant::dominant
trees::trees
cheaper::cheaper
line-of-sight::line-of-sight
synchronization::synchronization
roa::roa
listed::listed
closely::closely
international::international
combinations::combinations
during::during
260264::260264
resolve::resolve
crc::crc
clocks::clocks
common::common
activity::activity
switzerland::switzerland
x::x
locating::locating
scanning::scanning
set::set
achieved::achieved
kamarudin::kamarudin
achieves::achieves
see::see
are::are
2.3::2.3
2.2::2.2
2.1::2.1
2.6::2.6
2.5::2.5
2.4::2.4
icce::icce
probable::probable
fang::fang
currently::currently
various::various
numerous::numerous
available::available
recently::recently
targeted::targeted
koutsou::koutsou
scalability::scalability
interface::interface
relying::relying
both::both
c::c
10th::10th
last::last
license::license
annual::annual
sensitive::sensitive
improves::improves
long-term::long-term
experimental::experimental
geolocation::geolocation
point::point
ochieng::ochieng
simply::simply
suppressing::suppressing
expensive::expensive
consuming::consuming
802.11::802.11
publishing::publishing
due::due
describes::describes
maintenance::maintenance
collected::collected
pm::pm
flight::flight
kalman::kalman
modelling::modelling
determination::determination
demand::demand
xiong::xiong
estimations::estimations
evaluated::evaluated
while::while
evaluating::evaluating
error::error
guide::guide
fernandez::fernandez
30::30
costly::costly
vol::vol
drawbacks::drawbacks
xiao::xiao
maleki::maleki
gps-like::gps-like
commonly::commonly
grant::grant
widely::widely
2030::2030
9::9
products::products
prerequisite::prerequisite
higher::higher
development::development
calculation::calculation
attenuation::attenuation
//www.hindawi.com:://www.hindawi.com
triangulation::triangulation
moment::moment
levels::levels
uses::uses
user::user
robust::robust
recent::recent
knn::knn
lower::lower
database::database
anybody::anybody
analysis::analysis
person::person
machinery::machinery
nordin::nordin
gsm::gsm
spend::spend
distances::distances
deployment::deployment
reviewed::reviewed
cuartielles::cuartielles
world::world
regardless::regardless
alternative::alternative
al-ahmadi::al-ahmadi
embs::embs
also::also
signals::signals
source::source
location::location
transformation::transformation
marco::marco
march::march
894899::894899
aerospace::aerospace
quddus::quddus
d::d
follows::follows
signal::signal
communications::communications
indication::indication
popular::popular
mathematical::mathematical
google::google
33rd::33rd
methods::methods
dempster::dempster
creation::creation
some::some
back::back
//www.zigbee.org/about/:://www.zigbee.org/about/
3.4::3.4
3.2::3.2
3.3::3.3
sight::sight
3.1::3.1
latencies::latencies
measurements::measurements
eliminate::eliminate
innovation::innovation
minimal::minimal
t::t
be::be
rui::rui
processing::processing
agreement::agreement
step::step
iwssip::iwssip
by::by
state-of-the-art::state-of-the-art
bgm::bgm
simulation::simulation
range::range
block::block
aboodi::aboodi
aggarwal::aggarwal
into::into
within::within
241259::241259
clustering::clustering
skyhook::skyhook
statistics::statistics
probabilistic::probabilistic
submit::submit
custom::custom
hindawi::hindawi
handbook::handbook
sections::sections
angle-of-arrival::angle-of-arrival
properly::properly
line::line
youssef::youssef
deployed::deployed
zhu::zhu
icuwb::icuwb
transmits::transmits
up::up
icact::icact
z::z
similar::similar
called::called
associated::associated
defined::defined
specified::specified
chan::chan
metals::metals
thomsen::thomsen
engineering::engineering
shortrange::shortrange
surveying::surveying
%::%
nics::nics
application::application
yang::yang
electrical::electrical
recognition::recognition
indoor/outdoor::indoor/outdoor
elements::elements
users::users
calculating::calculating
problems::problems
medina::medina
allowing::allowing
structure::structure
svm::svm
e::e
algorithm::algorithm
vehicles::vehicles
diffraction::diffraction
2003::2003
2000::2000
2006::2006
presenting::presenting
2005::2005
inaccuracy::inaccuracy
2008::2008
2009::2009
requires::requires
incrementing::incrementing
hasbullah::hasbullah
gu::gu
results::results
existing::existing
illustrated::illustrated
issues::issues
deterministic::deterministic
send::send
intensive::intensive
include::include
pdas::pdas
subcarriers::subcarriers
wave::wave
tradeoffs::tradeoffs
positioningconcepts::positioningconcepts
bounding::bounding
categories::categories
tri::tri
transmission::transmission
positions::positions
notes::notes
f::f
1067::1067
prototypes::prototypes
configurations::configurations
locate::locate
smaller::smaller
1080::1080
traveling::traveling
concludes::concludes
download::download
manipulating::manipulating
dynamics::dynamics
carlo::carlo
business::business
campuses::campuses
expressed::expressed
find::find
access::access
19th::19th
experiment::experiment
routers::routers
;::;
3d::3d
adaptiveness::adaptiveness
led::led
respectively::respectively
commercial::commercial
1332::1332
growing::growing
objects::objects
separation::separation
making::making
39::39
38::38
parameters::parameters
33::33
32::32
31::31
larger::larger
37::37
36::36
35::35
34::34
suggests::suggests
survey::survey
implement::implement
involves::involves
named::named
aps::aps
addressed::addressed
api::api
use::use
from::from
consumption::consumption
&::&
next::next
few::few
start::start
reflects::reflects
on::on
zero-configuration::zero-configuration
219224::219224
antennas::antennas
detects::detects
iii::iii
photogrammetry::photogrammetry
185138::185138
integrating::integrating
this::this
challenge::challenge
averaged::averaged
zahid::zahid
control::control
providers::providers
process::process
0.2::0.2
high::high
effectively::effectively
tag::tag
k-nearest-neighbor::k-nearest-neighbor
delay::delay
varies::varies
animal::animal
instead::instead
intelligent::intelligent
buildings::buildings
collection::collection
belongings::belongings
efficiently::efficiently
geoinformation::geoinformation
manpower::manpower
light::light
lines::lines
healthcare::healthcare
rss-based::rss-based
stamped::stamped
produces::produces
move::move
meter::meter
including::including
jimenez::jimenez
regions::regions
decay::decay
lo::lo
rfid-based::rfid-based
labor::labor
estimating::estimating
khodayari::khodayari
2014::2014
societies::societies
2011::2011
2010::2010
2013::2013
2012::2012
269280::269280
guenda::guenda
fingerprint::fingerprint
satellites::satellites
transmitter::transmitter
university::university
transmitted::transmitted
mode::mode
subset::subset
globe::globe
hamedi::hamedi
related::related
bluetooth::bluetooth
society::society
frequency::frequency
static::static
measure::measure
our::our
/angulation::/angulation
agriculture::agriculture
out::out
respects::respects
140::140
01-01-02-sf0788::01-01-02-sf0788
obstructions::obstructions
performs::performs
adaptive::adaptive
cause::cause
integrated::integrated
lateration/trilateration/multilateration::lateration/trilateration/multilateration
approaches::approaches
g::g
determining::determining
times::times
derivations::derivations
fingerprinting-based::fingerprinting-based
hence::hence
263282::263282
austin::austin
vorst::vorst
3949::3949
scene::scene
quality::quality
management::management
hyperbolic::hyperbolic
unknown::unknown
system::system
adopted::adopted
their::their
pervasive::pervasive
2-3::2-3
acquire::acquire
devicescape::devicescape
environmental::environmental
fuzzy::fuzzy
july::july
updating::updating
rss::rss
observed::observed
measured::measured
context-dependent::context-dependent
bed::bed
rosdiadee::rosdiadee
reproduction::reproduction
1.1::1.1
1.3::1.3
curves::curves
have::have
close::close
need::need
11th::11th
acceleration::acceleration
atia::atia
angle::angle
able::able
incorporating::incorporating
which::which
multilateration::multilateration
=::=
accuracy::accuracy
worldwide::worldwide
device::device
segment::segment
why::why
so-called::so-called
placement::placement
segura::segura
neighboring::neighboring
graphs::graphs
proceedings::proceedings
emerging::emerging
selection::selection
dbm::dbm
indoor::indoor
rotating::rotating
purely::purely
lse::lse
principal::principal
based::based
knowledge::knowledge
operational::operational
local::local
hope::hope
exchanged::exchanged
nonline-of-sight::nonline-of-sight
handle::handle
means::means
canyons::canyons
overall::overall
joint::joint
vossiek::vossiek
timing::timing
penetrate::penetrate
lobs::lobs
areas::areas
liu::liu
362::362
fixed::fixed
view::view
enhances::enhances
requirement::requirement
computed::computed
exists::exists
national::national
in-building::in-building
module::module
operates::operates
computer::computer
enhanced::enhanced
phases::phases
multifloor::multifloor
wisp::wisp
pattern::pattern
state::state
identification::identification
closed::closed
progress::progress
ability::ability
importance::importance
jamieson::jamieson
emitted::emitted
deliver::deliver
interfere::interfere
propagation-time::propagation-time
key::key
emitter::emitter
yahoo.com::yahoo.com
extendable::extendable
33.75::33.75
etc::etc
navizon::navizon
estimation::estimation
cm::cm
wall::wall
environments::environments
m10::m10
table::table
li::li
600::600
10681073::10681073
143150::143150
moghtadaiee::moghtadaiee
addition::addition
wpans::wpans
yao::yao
utilizing::utilizing
define::define
adapting::adapting
corresponding::corresponding
angles::angles
improved::improved
an::an
present::present
smartphones::smartphones
splits::splits
unlike::unlike
value::value
will::will
layer::layer
almost::almost
thus::thus
site::site
hardware::hardware
dual::dual
lightweight::lightweight
orthogonal::orthogonal
regression::regression
capture::capture
radiation::radiation
parts::parts
units::units
android::android
infer::infer
zeroconfiguration::zeroconfiguration
http::http
1-2::1-2
effect::effect
phy::phy
wide-scale::wide-scale
frequently::frequently
laborious::laborious
kebangsaan::kebangsaan
off::off
reflection::reflection
neural::neural
i::i
obstacles::obstacles
well::well
hotmobile::hotmobile
residuals::residuals
sets::sets
firstly::firstly
comparisons::comparisons
sensing::sensing
358::358
csss::csss
heavily::heavily
42::42
proximity::proximity
obtain::obtain
sources::sources
stored::stored
noureldin::noureldin
rapid::rapid
density::density
localizability::localizability
residential::residential
supply::supply
add::add
match::match
increased::increased
february::february
elapsed::elapsed
increases::increases
denser::denser
press::press
intersection::intersection
prominent::prominent
loss::loss
necessary::necessary
like::like
fingerprints::fingerprints
setups::setups
become::become
works::works
amendment::amendment
poor::poor
because::because
110::110
transport::transport
does::does
?::?
limitations::limitations
biology::biology
noise::noise
selecting::selecting
journal::journal
pp::pp
fluorescent::fluorescent
analyses::analyses
r::r
periodically::periodically
stage::stage
gained::gained
about::about
actual::actual
carried::carried
getting::getting
recognized::recognized
compatible::compatible
software::software
coverage::coverage
previously::previously
functional::functional
ultrasound::ultrasound
k-nearest::k-nearest
consecutively::consecutively
networking::networking
additional::additional
transfer::transfer
zurich::zurich
spots::spots
smoothing::smoothing
dehaene::dehaene
banerjee::banerjee
but::but
hu::hu
volume::volume
repeated::repeated
hierarchical::hierarchical
gain::gain
delivers::delivers
compute::compute
places::places
whether::whether
cells::cells
j::j
variations::variations
record::record
problem::problem
minutes::minutes
bearing::bearing
100110::100110
ftra::ftra
life::life
lateration::lateration
ins::ins
well-defined::well-defined
relates::relates
rawcon::rawcon
iccsnt::iccsnt
gielen::gielen
compared::compared
48::48
variety::variety
46::46
47::47
44::44
45::45
percent::percent
43::43
40::40
41::41
other::other
compares::compares
conclusion::conclusion
canada::canada
francisco::francisco
june::june
percom::percom
friends::friends
factors::factors
csi::csi
portion::portion
4g::4g
sasi::sasi
mantripragada::mantripragada
augmented::augmented
