::
become::become
all::all
code::code
launched14::launched14
isotropically::isotropically
results::results
existing::existing
founded::founded
antennas::antennas
higher::higher
experiment::experiment
-73::-73
faster::faster
kupper::kupper
terminalassisted::terminalassisted
australia::australia
semiconductor::semiconductor
apartment::apartment
peter::peter
calculate::calculate
friedberg::friedberg
effort::effort
technique::technique
microwave::microwave
send::send
created::created
environment::environment
to::to
finally::finally
critical::critical
under::under
nodes::nodes
localizations::localizations
agreed::agreed
sent::sent
applied::applied
smartphone::smartphone
provides::provides
advantage::advantage
p3::p3
very::very
frequencies::frequencies
confounding::confounding
shows.19::shows.19
wave::wave
15::15
hallmann::hallmann
-70::-70
every::every
chooses::chooses
cellular::cellular
krishnamurthy::krishnamurthy
clemens::clemens
difference::difference
exact::exact
klaus::klaus
encounter::encounter
-76::-76
=access::=access
entire::entire
short-range::short-range
transmission::transmission
positions::positions
who::who
towers::towers
companies::companies
applicable::applicable
fewer::fewer
large::large
p::p
vector::vector
imagines::imagines
small::small
gammarays::gammarays
markov::markov
round::round
line-of::line-of
measuring::measuring
smaller::smaller
10m::10m
streets::streets
among::among
request::request
modified::modified
270::270
located::located
second::second
street::street
design::design
stroz::stroz
go::go
pass::pass
dnkler::dnkler
manipulating::manipulating
air::air
spin-off::spin-off
penetrated::penetrated
even::even
index::index
errors::errors
plays::plays
phaseshift::phaseshift
clock::clock
positioning20::positioning20
sun::sun
section::section
-27::-27
4::4
thickness::thickness
current::current
comparision::comparision
version::version
axel::axel
petri::petri
above::above
retrieved::retrieved
new::new
nurse::nurse
increasing::increasing
badge::badge
method::method
contrast::contrast
//www.gpsworld.com/wireless/indoor-positioning/:://www.gpsworld.com/wireless/indoor-positioning/
body::body
full::full
tags::tags
ptr::ptr
to,6::to,6
never::never
commercial::commercial
here::here
understanding::understanding
water::water
following::following
beacon::beacon
protection::protection
baseball::baseball
free::free
address::address
active::active
path::path
november::november
strong::strong
32905::32905
change::change
wait::wait
sending::sending
search::search
hegarty::hegarty
incoming::incoming
1000mw::1000mw
noticeable::noticeable
receive::receive
items::items
leaves::leaves
changed::changed
allows::allows
approaches::approaches
35::35
abstractwifi::abstractwifi
p2::p2
resulting::resulting
published::published
usually::usually
wardrivering.9::wardrivering.9
suitable::suitable
navigation::navigation
jami::jami
patents::patents
patrick::patrick
body.13::body.13
useful::useful
in18::in18
extra::extra
ground::ground
explained::explained
multi-storey::multi-storey
customised::customised
gulden::gulden
indoors::indoors
approches::approches
movement::movement
1st::1st
helsinki::helsinki
2,4::2,4
works.15::works.15
01/18/2012::01/18/2012
univ::univ
sensors::sensors
unit::unit
remaining::remaining
standing::standing
jan::jan
use::use
bidirectionally::bidirectionally
from::from
network-based::network-based
would::would
0::0
beginning::beginning
binghao::binghao
give::give
two::two
next::next
few::few
sequence::sequence
therefore::therefore
6::6
d::d
communications::communications
themselves::themselves
techniques::techniques
type::type
today::today
more::more
possession::possession
preparation::preparation
algorithms::algorithms
incident::incident
becomes::becomes
company::company
eferences::eferences
corrected::corrected
glass::glass
train::train
lahteenmaki::lahteenmaki
real-time::real-time
known::known
90::90
cases::cases
pieces::pieces
iii::iii
must::must
customer::customer
hardware::hardware
account::account
1995::1995
room::room
1997::1997
this::this
challenge::challenge
work::work
aerosp::aerosp
installing::installing
sequence-based::sequence-based
mw::mw
itself::itself
values::values
can::can
determining::determining
industrial::industrial
location-based::location-based
drops::drops
according::according
example::example
control::control
us-patent::us-patent
weaker::weaker
figure::figure
scan::scan
process::process
programming::programming
delivers::delivers
wilfried::wilfried
tu-berlin::tu-berlin
topic::topic
misikangas::misikangas
minimum::minimum
geolocation::geolocation
performed::performed
positioning.18::positioning.18
sense::sense
sought::sought
station::station
//www.ieee802.org/11/index.shtml:://www.ieee802.org/11/index.shtml
vtt::vtt
simple::simple
ratio::ratio
information::information
needs::needs
transmitting::transmitting
requirements::requirements
january::january
provide::provide
01/01/2012::01/01/2012
get::get
feature::feature
trilateration::trilateration
1::1
maps::maps
varies::varies
edge::edge
actual::actual
fourth::fourth
optimal::optimal
widespread::widespread
absolute::absolute
wales::wales
map::map
buildings::buildings
wips::wips
fingerprinting-based::fingerprinting-based
aoa::aoa
influenced::influenced
may::may
after::after
wifi-measurements::wifi-measurements
collection::collection
reflect::reflect
applications::applications
mac::mac
plane::plane
snr::snr
designed::designed
waves::waves
improving::improving
such::such
vossiek::vossiek
geometrical::geometrical
data::data
man::man
a::a
-54::-54
changes::changes
introduced::introduced
-50::-50
third::third
-52::-52
wheelchair::wheelchair
ishrat::ishrat
lines::lines
robot::robot
ghz::ghz
element::element
patent::patent
sons::sons
so::so
south::south
keeps::keeps
eirp::eirp
geographic::geographic
equation::equation
talk::talk
martin::martin
//www.cisco.com/en/us/docs/solutions/enterprise/mobility/wifich2.html:://www.cisco.com/en/us/docs/solutions/enterprise/mobility/wifich2.html
echnology::echnology
help::help
office::office
correlation::correlation
wikipedia.org::wikipedia.org
indeed::indeed
over::over
move::move
distance.8::distance.8
installed::installed
course::course
paper::paper
through::through
looks::looks
statistical::statistical
mentioned::mentioned
wlan::wlan
still::still
ieee::ieee
its::its
before::before
magazine::magazine
25::25
group::group
jersey::jersey
22::22
how::how
somewhere::somewhere
interesting::interesting
fix::fix
coordinates::coordinates
actually::actually
better::better
previously::previously
offers::offers
fig::fig
lp::lp
2401::2401
decreased::decreased
hidden::hidden
2011::2011
-59::-59
bssid.3::bssid.3
2012::2012
r.f::r.f
tri::tri
them::them
good::good
return::return
matches::matches
material::material
reflected::reflected
9::9
walls::walls
calibration-phase::calibration-phase
they::they
instead::instead
not::not
//www.google.com:://www.google.com
township::township
now::now
1rd::1rd
hall::hall
wiley::wiley
matched::matched
tero::tero
transmitter::transmitter
gets::gets
airports::airports
lies::lies
horus::horus
always::always
university::university
cell::cell
l::l
capability::capability
cisco.com::cisco.com
mode::mode
andrew::andrew
turns::turns
found::found
identifies::identifies
difficult::difficult
ifi::ifi
mean::mean
r::r
england::england
covered::covered
bump::bump
ed::ed
energy::energy
termswifi::termswifi
lan::lan
related::related
solution::solution
line::line
frequency::frequency
static::static
laitinen::laitinen
performs::performs
measurement::measurement
our::our
bay::bay
special::special
out::out
principles::principles
deals::deals
shown::shown
device.7::device.7
jul::jul
network::network
3rd::3rd
factors::factors
furthermore::furthermore
since::since
interference::interference
requires::requires
looking::looking
-65::-65
laid::laid
socalled::socalled
7::7
1999::1999
receiving::receiving
supports::supports
occurs::occurs
shows::shows
mistakes::mistakes
outdoors.2::outdoors.2
working::working
theory::theory
barrier::barrier
localization::localization
commits::commits
positional::positional
million::million
mechanisms::mechanisms
given::given
possibility::possibility
standard::standard
bumps::bumps
complicated::complicated
estimate::estimate
wi-fi::wi-fi
likelihood::likelihood
possibly::possibly
log::log
watts::watts
river::river
g::g
e.g::e.g
geometry::geometry
service-centric::service-centric
could::could
transition::transition
positioning::positioning
phy::phy
dipl.-wirtsch.-ing::dipl.-wirtsch.-ing
times::times
pahlavan::pahlavan
jumping::jumping
place::place
w::w
assumed::assumed
barriers::barriers
neglected::neglected
locating::locating
onto::onto
speeds::speeds
first::first
origin::origin
already::already
ntroduction::ntroduction
dont::dont
striking::striking
fading::fading
omitted::omitted
coming::coming
number::number
one::one
channels::channels
floors::floors
done::done
occurrences::occurrences
another::another
array::array
sklar::sklar
mix::mix
size::size
passes::passes
differ::differ
cranfield::cranfield
exists::exists
service::service
v::v
ws2011/2012::ws2011/2012
unequivocal::unequivocal
90-100::90-100
system::system
adopted::adopted
their::their
returns::returns
2::2
quade::quade
doesnt::doesnt
handbook::handbook
toa::toa
ali::ali
mobiles::mobiles
gps::gps
urban::urban
lot::lot
airwaves::airwaves
that::that
pittsburgh::pittsburgh
nibble::nibble
exactly::exactly
realized::realized
required::required
environmental::environmental
regards::regards
copy::copy
than::than
rss::rss
std::std
distance::distance
milliwatt::milliwatt
b::b
determines::determines
unfortunately::unfortunately
17::17
edition::edition
19::19
18::18
database::database
enabled::enabled
transferred::transferred
modelled::modelled
inversely::inversely
nevertheless::nevertheless
patients::patients
determined::determined
ontrilateration::ontrilateration
supposed::supposed
amplitude::amplitude
were::were
k::k
negatively::negatively
enables::enables
sensing::sensing
result::result
collecting::collecting
lbs::lbs
rene::rene
san::san
interferences.22::interferences.22
harris::harris
calculation::calculation
walkbase::walkbase
spectrum::spectrum
attenuation::attenuation
headquarters::headquarters
14::14
medium::medium
degrees.17::degrees.17
anytime::anytime
have::have
further::further
need::need
seen::seen
any::any
seminar::seminar
dozen::dozen
strength::strength
angle::angle
mostly::mostly
zero::zero
depending::depending
latter::latter
tuple::tuple
able::able
ideas::ideas
bages::bages
note::note
equipment::equipment
recommended::recommended
potential::potential
absorbed::absorbed
build::build
which::which
kaplan::kaplan
transmit::transmit
performance::performance
strengths::strengths
=::=
switching::switching
accuracy::accuracy
circles::circles
200::200
relatively::relatively
normal::normal
log-normal.12::log-normal.12
measures::measures
microwaves::microwaves
gstumbler::gstumbler
reach::reach
most::most
time.1::time.1
connected::connected
30dbm::30dbm
entry::entry
device::device
utilize::utilize
comparison::comparison
measured::measured
bsa::bsa
divergences::divergences
so-called::so-called
sdk::sdk
especially::especially
mobile::mobile
gsm::gsm
calculated::calculated
sometimes::sometimes
m::m
repeated::repeated
etermination::etermination
concepts::concepts
points::points
principle::principle
-66::-66
redirected::redirected
propagation-loss::propagation-loss
physics::physics
+::+
fact::fact
sussex::sussex
dbm::dbm
localisation::localisation
germany::germany
rayleigh::rayleigh
20dbm::20dbm
-55::-55
detection::detection
indoor::indoor
dependant::dependant
ending::ending
rtt::rtt
attempts::attempts
radio::radio
solutions::solutions
terminal-based::terminal-based
range::range
recording::recording
leiteritz::leiteritz
find::find
staff::staff
redirect::redirect
access::access
-49::-49
based::based
favourable::favourable
-43::-43
-40::-40
-46::-46
3::3
should::should
terminal::terminal
surroundings::surroundings
only::only
easurement::easurement
factor::factor
integrate::integrate
8::8
adequate::adequate
partially::partially
local::local
proximity::proximity
achieve::achieve
characterization::characterization
do::do
handle::handle
goes::goes
10::10
offline-phase::offline-phase
simplest::simplest
watch::watch
kind::kind
famous::famous
synchronization::synchronization
christopher::christopher
fastest::fastest
reply::reply
timing::timing
during::during
;::;
areas::areas
well::well
sensor::sensor
radar::radar
upper::upper
leif::leif
16::16
cells::cells
summary::summary
tdoa::tdoa
clocks::clocks
wendi::wendi
architecture::architecture
london::london
fixed::fixed
where::where
inside::inside
view::view
finlan::finlan
reveals::reveals
requirement::requirement
set::set
mandatory::mandatory
reference::reference
attenuated::attenuated
national::national
saddle::saddle
humans::humans
module::module
operates::operates
relative::relative
opposite::opposite
see::see
individual::individual
radius::radius
are::are
equip::equip
suited::suited
collects::collects
r2003::r2003
alternative::alternative
best::best
subject::subject
instance::instance
practice::practice
said::said
/hostednews/ap/article/aleqm5j8g0w0gstlrznxfyd0kbi7e6idug::/hostednews/ap/article/aleqm5j8g0w0gstlrznxfyd0kbi7e6idug
pattern::pattern
away::away
equal::equal
indoorpositioning::indoorpositioning
vol::vol
enough::enough
smallest::smallest
identification::identification
finger::finger
radiated::radiated
between::between
probably::probably
prentice::prentice
approach::approach
ositioning::ositioning
available::available
gives::gives
we::we
infrastructure::infrastructure
terms::terms
creating::creating
initially::initially
-90::-90
outdoors::outdoors
deliver::deliver
however::however
poorer::poorer
experiment,13::experiment,13
authorities::authorities
dempster::dempster
cities::cities
come::come
autonomous::autonomous
improve::improve
10-20::10-20
received::received
hits::hits
last::last
2002::2002
desired::desired
liv::liv
many::many
cars::cars
directional::directional
space::space
chosen::chosen
connection::connection
figures::figures
planned::planned
receives::receives
receiver::receiver
estimation::estimation
expression::expression
guarantee::guarantee
comes::comes
otherwise::otherwise
100mw::100mw
and::and
ci::ci
2003::2003
afterwards::afterwards
point::point
wall::wall
overview::overview
others::others
corresponds::corresponds
environments::environments
except::except
dimensional::dimensional
ley::ley
table::table
250::250
swindon::swindon
passive::passive
consuming::consuming
802.11::802.11
-35::-35
basis::basis
equivalent::equivalent
west::west
bosten::bosten
three::three
been::been
strategy::strategy
willi::willi
much::much
basic::basic
collected::collected
brick::brick
originates::originates
hardly::hardly
estimated::estimated
systems::systems
website::website
direction::direction
shopping::shopping
sydney::sydney
both::both
jaakko::jaakko
wieghardt::wieghardt
c::c
1mw::1mw
locations::locations
photos::photos
determination::determination
disruptive::disruptive
child::child
worked::worked
general::general
present::present
case::case
-72::-72
-71::-71
p1::p1
/::/
-75::-75
-74::-74
these::these
artech::artech
straight::straight
lessen::lessen
single::single
value::value
n::n
will::will
euclidean::euclidean
while::while
onclusion::onclusion
siemens::siemens
error::error
nokia::nokia
property::property
robin::robin
layer::layer
larger::larger
florida::florida
then::then
almost::almost
characteristics::characteristics
is::is
thus::thus
it::it
iv::iv
ii::ii
examined::examined
malls::malls
aeroscout::aeroscout
in::in
comparative::comparative
technology::technology
id::id
if::if
dept::dept
different::different
inc::inc
ormondroyd::ormondroyd
-62::-62
perform::perform
make::make
radiation::radiation
s::s
same::same
submission::submission
beside::beside
food::food
complex::complex
myllymaki::myllymaki
pauli::pauli
2005::2005
modification::modification
decibel::decibel
elliott::elliott
several::several
prerequisite::prerequisite
entitled::entitled
satellite::satellite
used::used
http::http
navizon::navizon
closest::closest
effect::effect
rain::rain
hand::hand
triangulation::triangulation
boston::boston
running::running
edges::edges
uses::uses
user::user
4.1::4.1
functionality::functionality
opportunity::opportunity
identity::identity
good-working::good-working
tracking::tracking
least::least
reflection::reflection
1978::1978
i::i
whole::whole
-67::-67
arrival::arrival
nordstrom::nordstrom
analysis::analysis
patterns::patterns
without::without
greatest::greatest
21::21
rate.11::rate.11
coordinate::coordinate
position::position
the::the
stongest::stongest
corporate::corporate
kaemarungsi::kaemarungsi
usual::usual
advertises::advertises
distances::distances
0,00001::0,00001
outdoor::outdoor
just::just
less::less
increasingly::increasingly
captures::captures
accurate::accurate
fingerprint::fingerprint
networks::networks
ommercial::ommercial
valuable::valuable
arriving::arriving
stored::stored
properties::properties
farther::farther
human::human
behind::behind
switched::switched
project4::project4
extracted::extracted
speed::speed
bit::bit
apple::apple
profitable::profitable
jose::jose
intersection::intersection
preparations::preparations
also::also
peng::peng
widespreading::widespreading
guaranteed::guaranteed
attractive::attractive
signals::signals
source::source
add::add
spread::spread
location::location
easy::easy
finland::finland
role::role
has::has
180::180
transformation::transformation
take::take
real::real
makes::makes
vii::vii
synchronisation::synchronisation
increased::increased
depends::depends
read::read
big::big
online::online
possible::possible
topology::topology
finding::finding
predetermined::predetermined
know::know
background::background
guide::guide
2010::2010
using::using
part::part
unique::unique
disadvantage::disadvantage
loss::loss
modifications::modifications
compensates::compensates
necessary::necessary
like::like
lost::lost
bssids::bssids
signal::signal
fingerprints::fingerprints
extremely::extremely
server::server
collect::collect
heory::heory
a/b/g/n::a/b/g/n
t::t
lose::lose
popular::popular
decrease::decrease
works::works
essential::essential
13::13
google::google
cisco::cisco
methods::methods
hierarchy::hierarchy
people::people
sends::sends
affects::affects
phase::phase
patented::patented
some::some
back::back
dead::dead
born::born
strongest::strongest
meters::meters
choosing::choosing
synchronically::synchronically
multiple::multiple
-30::-30
recognition::recognition
happens::happens
possibilities::possibilities
fingerprinting::fingerprinting
technology.16::technology.16
specifications::specifications
for::for
overlay::overlay
broadband::broadband
electromagnetic::electromagnetic
//www.skyhookwireless.com/:://www.skyhookwireless.com/
measurements::measurements
recorded::recorded
xample::xample
per::per
wheremops::wheremops
piscataway::piscataway
when::when
does::does
economical::economical
googles::googles
?::?
locate::locate
be::be
noise::noise
run::run
inaccurate::inaccurate
power::power
routers::routers
converts::converts
each::each
pp::pp
illustration::illustration
interval::interval
step::step
benefit::benefit
although::although
topologie::topologie
described::described
refers::refers
by::by
soluions::soluions
takes::takes
chapter::chapter
on::on
about::about
central::central
usa::usa
stations::stations
of::of
industry::industry
&::&
discussed::discussed
ids::ids
reduced::reduced
compatible::compatible
carries::carries
vehicle-based::vehicle-based
steadily::steadily
illustation::illustation
discusses::discusses
consequently::consequently
or::or
software::software
vi::vi
reckoning::reckoning
own::own
coverage::coverage
bssid::bssid
presence::presence
beacons::beacons
communication::communication
into::into
within::within
tag::tag
due::due
services::services
ltd::ltd
because::because
determine::determine
proportional::proportional
2000::2000
nowadays::nowadays
wittmann::wittmann
often::often
skyhook::skyhook
fast::fast
networking::networking
additional::additional
john::john
area::area
ghz.10::ghz.10
topologies::topologies
support::support
there::there
question::question
approximate::approximate
specifically::specifically
start::start
topologien::topologien
low::low
way::way
house::house
xps::xps
call::call
was::was
.5::.5
confessed2::confessed2
iphone::iphone
function::function
walls.21::walls.21
hard::hard
form::form
offer::offer
fundamentals::fundamentals
great::great
ekahau::ekahau
but::but
idea::idea
wireless::wireless
taken::taken
heat::heat
mproving::mproving
munich::munich
technologies::technologies
with::with
he::he
made::made
compute::compute
11::11
whether::whether
attenuate::attenuate
j::j
attached::attached
up::up
devices::devices
windows::windows
converted::converted
heikki::heikki
0.001::0.001
uk::uk
doors::doors
palm::palm
problem::problem
called::called
strongly::strongly
model::model
later::later
associated::associated
sight::sight
hoffmann::hoffmann
certain::certain
stein::stein
measure::measure
influence::influence
lateration::lateration
an::an
as::as
right::right
at::at
20::20
hospitals::hospitals
trip::trip
interferences::interferences
physical::physical
-60::-60
again::again
functions::functions
-63::-63
-64::-64
us::us
antenna::antenna
no::no
-68::-68
-69::-69
hybrid::hybrid
rs::rs
application::application
other::other
5::5
henniges::henniges
digital::digital
patterning::patterning
//www.iis.fraunhofer.de/bf/ln/technologie/aoa/:://www.iis.fraunhofer.de/bf/ln/technologie/aoa/
training-phase::training-phase
developers::developers
conclusion::conclusion
node::node
users::users
calculating::calculating
preceding::preceding
printing::printing
problems::problems
robots::robots
includes::includes
applywifi.com::applywifi.com
inaccuracy::inaccuracy
chance::chance
important::important
cater::cater
terminal-assisted::terminal-assisted
additionally::additionally
variable::variable
docid=23e2d91de68f47d482524fb8a4f34a41::docid=23e2d91de68f47d482524fb8a4f34a41
7,349,683::7,349,683
building::building
2009::2009
e::e
longer::longer
imprecise::imprecise
wifi::wifi
calculates::calculates
raphael::raphael
scans::scans
circuit::circuit
2001::2001
2006::2006
2007::2007
wiebking::wiebking
time::time
far::far
rural::rural
2008::2008
12::12
starting::starting
evenly::evenly
